Event	Country
Barton Trail parkrun	Canada
Bower Park parkrun	United Kingdom
Carlisle Park parkrun	United Kingdom
Chevin Forest parkrun	United Kingdom
Cyril Curtain Reserve parkrun	Australia
Dundalk IT junior parkrun	Ireland
Hellbrunn parkrun	Austria
Henry Kendall Reserve parkrun	Australia
Hillsborough junior parkrun	United Kingdom
Horspath parkrun	United Kingdom
Nathalia Showgrounds parkrun	Australia
Patawalonga River parkrun	Australia
Peel parkrun	United Kingdom
Ringsend junior parkrun	Ireland
Sharpham Road Playing Fields parkrun	United Kingdom
St Mary’s Campus junior parkrun	Ireland
Woodgate Valley Country Park parkrun	United Kingdom
parkrun Lasek Marceliński	Poland
parkrun park 30-letiya Oktyabrya	Russia
