Event	Country
Beatrixpark parkrun	Netherlands
Brauhaus Afrika parkrun	South Africa
Ed Austin Regional parkrun	United States
Evergreen parkrun	United States
Exploration Place parkrun	United States
Harayama koen parkrun	Japan
Heijo kyuseki Rekishi koen parkrun	Japan
Jerrabomberra Mountain Reserve parkrun	Australia
Lahden satama parkrun	Finland
Mtunzini parkrun	South Africa
Nolen’s Park parkrun	Australia
Peckham Rye junior parkrun	United Kingdom
Robelle Domain parkrun	Australia
Stopline Way junior parkrun	United Kingdom
Traumschleife Bärenbachpfad parkrun	Germany
Tynwald Park parkrun	Australia
Whakatane Gardens parkrun	New Zealand
parkrun Park Miejski, Łowicz	Poland
parkrun Zielony Jar	Poland
