Event	Country	Cancellation Note
Aachener Weiher parkrun	Germany	COVID-19 (Coronavirus)
Aberbeeg parkrun	United Kingdom	COVID-19 (Coronavirus)
Aberdare parkrun	United Kingdom	COVID-19 (Coronavirus)
Aberdeen parkrun	United Kingdom	COVID-19 (Coronavirus)
Aberystwyth junior parkrun	United Kingdom	COVID-19 (Coronavirus)
Aberystwyth parkrun	United Kingdom	COVID-19 (Coronavirus)
Abingdon parkrun	United Kingdom	COVID-19 (Coronavirus)
Achill Greenway parkrun	Ireland	COVID-19 (Coronavirus)
Aggeneys parkrun	South Africa	COVID-19 (Coronavirus)
Agnew parkrun	United Kingdom	COVID-19 (Coronavirus)
Albert College junior parkrun	Ireland	COVID-19 (Coronavirus)
Albert parkrun, Middlesbrough	United Kingdom	COVID-19 (Coronavirus)
Alberton Ascot parkrun	Australia	COVID-19 Restrictions in place
Alberts Farm parkrun	South Africa	COVID-19 (Coronavirus)
Aldenham parkrun	United Kingdom	COVID-19 (Coronavirus)
Alderford Lake parkrun	United Kingdom	COVID-19 (Coronavirus)
Alexandra junior parkrun, Oldham	United Kingdom	COVID-19 (Coronavirus)
Alexandra parkrun, Moss Side	United Kingdom	COVID-19 (Coronavirus)
Alice Campus parkrun, University of Fort Hare	South Africa	COVID-19 (Coronavirus)
Alice Holt parkrun	United Kingdom	COVID-19 (Coronavirus)
Aliwal North parkrun	South Africa	COVID-19 (Coronavirus)
Ally Pally parkrun	United Kingdom	COVID-19 (Coronavirus)
Alness parkrun	United Kingdom	COVID-19 (Coronavirus)
Alstervorland parkrun	Germany	COVID-19 (Coronavirus)
Altcourse parkrun	United Kingdom	COVID-19 (Coronavirus)
Alvaston parkrun	United Kingdom	COVID-19 (Coronavirus)
Alyn Waters junior parkrun	United Kingdom	COVID-19 (Coronavirus)
Amanzimtoti parkrun	South Africa	COVID-19 (Coronavirus)
Amsterdamse Bos parkrun	Netherlands	COVID-19 (Coronavirus)
An Bonnán Buí parkrun	Ireland	COVID-19 (Coronavirus)
Anacostia parkrun	United States	COVID-19 (Coronavirus)
Andover parkrun	United Kingdom	COVID-19 (Coronavirus)
Angrignon parkrun	Canada	COVID-19 (Coronavirus)
Appleton Thorn parkrun	United Kingdom	COVID-19 (Coronavirus)
Ardgillan parkrun	Ireland	COVID-19 (Coronavirus)
Arklow Duck Pond junior parkrun	Ireland	COVID-19 (Coronavirus)
Armley parkrun	United Kingdom	COVID-19 (Coronavirus)
Arrow Valley parkrun	United Kingdom	COVID-19 (Coronavirus)
Ashburton parkrun	South Africa	COVID-19 (Coronavirus)
Ashford parkrun	United Kingdom	COVID-19 (Coronavirus)
Ashton Court parkrun	United Kingdom	COVID-19 (Coronavirus)
Athlone parkrun	Ireland	COVID-19 (Coronavirus)
Atholl parkrun	South Africa	COVID-19 (Coronavirus)
Atlasville parkrun	South Africa	COVID-19 (Coronavirus)
Avery Beach parkrun, Huntsville	Canada	COVID-19 (Coronavirus)
Aviemore parkrun	United Kingdom	COVID-19 (Coronavirus)
Avondale Forest parkrun	Ireland	COVID-19 (Coronavirus)
Aylesbury junior parkrun	United Kingdom	COVID-19 (Coronavirus)
Aylesbury parkrun	United Kingdom	COVID-19 (Coronavirus)
Ayr parkrun	United Kingdom	COVID-19 (Coronavirus)
Babbs Mill parkrun	United Kingdom	COVID-19 (Coronavirus)
Badhusparken parkrun	Sweden	COVID-19 (Coronavirus)
Bailey junior parkrun	United Kingdom	COVID-19 (Coronavirus)
Bakewell parkrun	United Kingdom	COVID-19 (Coronavirus)
Balbriggan junior parkrun	Ireland	COVID-19 (Coronavirus)
Ballina junior parkrun	Ireland	COVID-19 (Coronavirus)
Ballina parkrun	Ireland	COVID-19 (Coronavirus)
Ballincollig Regional junior parkrun	Ireland	COVID-19 (Coronavirus)
Ballincollig parkrun	Ireland	COVID-19 (Coronavirus)
Ballito parkrun	South Africa	COVID-19 (Coronavirus)
Ballyogan junior parkrun	Ireland	COVID-19 (Coronavirus)
Bambra Bolinda parkrun	Australia	COVID-19 Restrictions in place
Banbury parkrun	United Kingdom	COVID-19 (Coronavirus)
Bankton Mains Park junior parkrun	United Kingdom	COVID-19 (Coronavirus)
Banstead Woods parkrun	United Kingdom	COVID-19 (Coronavirus)
Barclay parkrun	United Kingdom	COVID-19 (Coronavirus)
Barking parkrun	United Kingdom	COVID-19 (Coronavirus)
Barnsley junior parkrun	United Kingdom	COVID-19 (Coronavirus)
Barnsley parkrun	United Kingdom	COVID-19 (Coronavirus)
Barnstaple parkrun	United Kingdom	COVID-19 (Coronavirus)
Barrow parkrun	United Kingdom	COVID-19 (Coronavirus)
Barry Island parkrun	United Kingdom	COVID-19 (Coronavirus)
Barry junior parkrun	United Kingdom	COVID-19 (Coronavirus)
Barshaw junior parkrun	United Kingdom	COVID-19 (Coronavirus)
Basildon parkrun	United Kingdom	COVID-19 (Coronavirus)
Basingstoke parkrun	United Kingdom	COVID-19 (Coronavirus)
Bath Skyline parkrun	United Kingdom	COVID-19 (Coronavirus)
Battery Park junior parkrun	United Kingdom	COVID-19 (Coronavirus)
Beach Strip parkrun	Canada	COVID-19 (Coronavirus)
Beacon parkrun	United Kingdom	COVID-19 (Coronavirus)
Bear Brook parkrun	United Kingdom	COVID-19 (Coronavirus)
Beckenham Place parkrun	United Kingdom	COVID-19 (Coronavirus)
Beckton parkrun	United Kingdom	COVID-19 (Coronavirus)
Bedfont Lakes parkrun	United Kingdom	COVID-19 (Coronavirus)
Bedford junior parkrun	United Kingdom	COVID-19 (Coronavirus)
Bedford parkrun	United Kingdom	COVID-19 (Coronavirus)
Bedgebury Pinetum parkrun	United Kingdom	COVID-19 (Coronavirus)
Bedok Reservoir parkrun	Singapore	COVID-19 (Coronavirus)
Bedworth parkrun	United Kingdom	COVID-19 (Coronavirus)
Beechpark junior parkrun	Ireland	COVID-19 (Coronavirus)
Beeston parkrun	United Kingdom	COVID-19 (Coronavirus)
Bellevue parkrun	Canada	COVID-19 (Coronavirus)
Belloluogo parkrun	Italy	COVID-19 (Coronavirus)
Bells Inn parkrun	South Africa	COVID-19 (Coronavirus)
Bellville parkrun	South Africa	COVID-19 (Coronavirus)
Belton House parkrun	United Kingdom	COVID-19 (Coronavirus)
Bere Island parkrun	Ireland	COVID-19 (Coronavirus)
Berkeley Green parkrun	United Kingdom	COVID-19 (Coronavirus)
Berwyn parkrun	United Kingdom	COVID-19 (Coronavirus)
Bestwood Village parkrun	United Kingdom	COVID-19 (Coronavirus)
Bethlem Royal Hospital parkrun	United Kingdom	COVID-19 (Coronavirus)
Betty's Bay parkrun	South Africa	COVID-19 (Coronavirus)
Bevendean Down parkrun	United Kingdom	COVID-19 (Coronavirus)
Beverley Westwood parkrun	United Kingdom	COVID-19 (Coronavirus)
Bexley parkrun	United Kingdom	COVID-19 (Coronavirus)
Bezuidenhout parkrun	South Africa	COVID-19 (Coronavirus)
Bicester parkrun	United Kingdom	COVID-19 (Coronavirus)
Bickershaw parkrun	United Kingdom	COVID-19 (Coronavirus)
Bideford parkrun	United Kingdom	COVID-19 (Coronavirus)
Big Bay parkrun	South Africa	COVID-19 (Coronavirus)
Billericay parkrun	United Kingdom	COVID-19 (Coronavirus)
Billingham junior parkrun	United Kingdom	COVID-19 (Coronavirus)
Birches Valley junior parkrun	United Kingdom	COVID-19 (Coronavirus)
Birkenhead parkrun	United Kingdom	COVID-19 (Coronavirus)
Bishan parkrun	Singapore	COVID-19 (Coronavirus)
Black Combe parkrun	United Kingdom	COVID-19 (Coronavirus)
Black Park parkrun	United Kingdom	COVID-19 (Coronavirus)
Blackhill parkrun	United Kingdom	COVID-19 (Coronavirus)
Blackpool parkrun	United Kingdom	COVID-19 (Coronavirus)
Blandford parkrun	United Kingdom	COVID-19 (Coronavirus)
Blickling parkrun	United Kingdom	COVID-19 (Coronavirus)
Bloemhof parkrun	South Africa	COVID-19 (Coronavirus)
Blue Lagoon parkrun	South Africa	COVID-19 (Coronavirus)
Blyth Links parkrun	United Kingdom	COVID-19 (Coronavirus)
Bognor Regis parkrun	United Kingdom	COVID-19 (Coronavirus)
Boksburg parkrun	South Africa	COVID-19 (Coronavirus)
Bolberry Down parkrun	United Kingdom	COVID-19 (Coronavirus)
Bolton parkrun	United Kingdom	COVID-19 (Coronavirus)
Borrisokane Town parkrun	Ireland	COVID-19 (Coronavirus)
Bosmont Stadium parkrun	South Africa	COVID-19 (Coronavirus)
Boston parkrun	United Kingdom	COVID-19 (Coronavirus)
Botanical Garden parkrun	South Africa	COVID-19 (Coronavirus)
Bournemouth parkrun	United Kingdom	COVID-19 (Coronavirus)
Bower Park parkrun	United Kingdom	COVID-19 (Coronavirus)
Bowling Park parkrun	United Kingdom	COVID-19 (Coronavirus)
Bracknell parkrun	United Kingdom	COVID-19 (Coronavirus)
Bradford parkrun	United Kingdom	COVID-19 (Coronavirus)
Braidwood Showground parkrun	Australia	Grounds too wet and unsafe.
Brakpan parkrun	South Africa	COVID-19 (Coronavirus)
Bramhall parkrun	United Kingdom	COVID-19 (Coronavirus)
Bramley parkrun	United Kingdom	COVID-19 (Coronavirus)
Brandkop parkrun	South Africa	COVID-19 (Coronavirus)
Brandon Country Park parkrun	United Kingdom	COVID-19 (Coronavirus)
Braunstone parkrun	United Kingdom	COVID-19 (Coronavirus)
Bray junior parkrun	Ireland	COVID-19 (Coronavirus)
Breakwater parkrun	Canada	COVID-19 (Coronavirus)
Bredasdorp parkrun	South Africa	COVID-19 (Coronavirus)
Breede Valley parkrun	South Africa	COVID-19 (Coronavirus)
Brentwood junior parkrun	United Kingdom	COVID-19 (Coronavirus)
Brentwood parkrun	United Kingdom	COVID-19 (Coronavirus)
Bressay parkrun	United Kingdom	COVID-19 (Coronavirus)
Brickfields parkrun	Ireland	COVID-19 (Coronavirus)
Bridgend junior parkrun	United Kingdom	COVID-19 (Coronavirus)
Bridgetown parkrun	South Africa	COVID-19 (Coronavirus)
Brierley Forest parkrun	United Kingdom	COVID-19 (Coronavirus)
Brighouse parkrun	United Kingdom	COVID-19 (Coronavirus)
Brighton & Hove parkrun	United Kingdom	COVID-19 (Coronavirus)
Brixworth Country parkrun	United Kingdom	COVID-19 (Coronavirus)
Broadmeadow junior parkrun	United Kingdom	COVID-19 (Coronavirus)
Brockenhurst parkrun	United Kingdom	COVID-19 (Coronavirus)
Brockwell parkrun, Herne Hill	United Kingdom	COVID-19 (Coronavirus)
Bromley parkrun	United Kingdom	COVID-19 (Coronavirus)
Bronberrik parkrun	South Africa	COVID-19 (Coronavirus)
Bronkhorstspruit parkrun	South Africa	COVID-19 (Coronavirus)
Brooklands parkrun	United Kingdom	COVID-19 (Coronavirus)
Brueton parkrun	United Kingdom	COVID-19 (Coronavirus)
Brumby Wood Rec Ground junior parkrun	United Kingdom	COVID-19 (Coronavirus)
Brundall parkrun	United Kingdom	COVID-19 (Coronavirus)
Bryanston parkrun	South Africa	COVID-19 (Coronavirus)
Bryn Bach junior parkrun	United Kingdom	COVID-19 (Coronavirus)
Bryn Bach parkrun	United Kingdom	COVID-19 (Coronavirus)
Brynaman parkrun	United Kingdom	COVID-19 (Coronavirus)
Buckingham junior parkrun	United Kingdom	No available Run Directors
Buckingham parkrun	United Kingdom	COVID-19 (Coronavirus)
Bude Marshes junior parkrun	United Kingdom	COVID-19 (Coronavirus)
Bugasee parkrun, Kassel	Germany	COVID-19 (Coronavirus)
Bulithando parkrun	South Africa	COVID-19 (Coronavirus)
Buncrana parkrun	Ireland	COVID-19 (Coronavirus)
Burgess junior parkrun, County Tipperary	Ireland	COVID-19 (Coronavirus)
Burgess parkrun	United Kingdom	COVID-19 (Coronavirus)
Burnage parkrun	United Kingdom	COVID-19 (Coronavirus)
Burnham and Highbridge parkrun	United Kingdom	COVID-19 (Coronavirus)
Burnham-on-Crouch parkrun	United Kingdom	COVID-19 (Coronavirus)
Burnley junior parkrun	United Kingdom	Classic car show in the park.
Burnley parkrun	United Kingdom	COVID-19 (Coronavirus)
Burswood Peninsula parkrun	Australia	Stadium requirements
Bury St Edmunds parkrun	United Kingdom	COVID-19 (Coronavirus)
Bushy junior parkrun	United Kingdom	COVID-19 (Coronavirus)
Bushy parkrun	United Kingdom	COVID-19 (Coronavirus)
Bushy parkrun, Dublin	Ireland	COVID-19 (Coronavirus)
Cabinteely parkrun	Ireland	COVID-19 (Coronavirus)
Caffarella parkrun	Italy	COVID-19 (Coronavirus)
Caledonian junior parkrun	United Kingdom	COVID-19 (Coronavirus)
California Country parkrun	United Kingdom	COVID-19 (Coronavirus)
Callaghan parkrun	Australia	No landholder permission
Cambourne junior parkrun	United Kingdom	COVID-19 (Coronavirus)
Cambridge junior parkrun	United Kingdom	COVID-19 (Coronavirus)
Cambridge parkrun	United Kingdom	COVID-19 (Coronavirus)
Campaspe parkrun	Australia	Council Advice - storm damage to pathways
Camperdown parkrun, Dundee	United Kingdom	COVID-19 (Coronavirus)
Cannock Chase parkrun	United Kingdom	COVID-19 (Coronavirus)
Cannon Hill junior parkrun, Birmingham	United Kingdom	COVID-19 (Coronavirus)
Cannon Hill parkrun, Birmingham	United Kingdom	COVID-19 (Coronavirus)
Cannonvale junior parkrun	Australia	reopening requirements being completed
Canons Park parkrun	United Kingdom	COVID-19 (Coronavirus)
Canterbury parkrun	United Kingdom	COVID-19 (Coronavirus)
Cardiff junior parkrun	United Kingdom	COVID-19 (Coronavirus)
Cardiff parkrun	United Kingdom	COVID-19 (Coronavirus)
Carlisle Park parkrun	United Kingdom	COVID-19 (Coronavirus)
Carlisle parkrun	United Kingdom	COVID-19 (Coronavirus)
Carlow Town parkrun	Ireland	COVID-19 (Coronavirus)
Carmarthen junior parkrun	United Kingdom	COVID-19 (Coronavirus)
Cassiobury parkrun	United Kingdom	COVID-19 (Coronavirus)
Castle Demense parkrun	Ireland	COVID-19 (Coronavirus)
Castle Howard parkrun	United Kingdom	COVID-19 (Coronavirus)
Castle Park junior parkrun	United Kingdom	COVID-19 (Coronavirus)
Castle Park parkrun	United Kingdom	COVID-19 (Coronavirus)
Castlebar parkrun	Ireland	COVID-19 (Coronavirus)
Castleblayney parkrun	Ireland	COVID-19 (Coronavirus)
Castlehaven parkrun	Ireland	COVID-19 (Coronavirus)
Castlerea parkrun	Ireland	COVID-19 (Coronavirus)
Castletown parkrun	Ireland	COVID-19 (Coronavirus)
Castlewellan parkrun	United Kingdom	No landowner permission
Catford parkrun	United Kingdom	COVID-19 (Coronavirus)
Catterick parkrun	United Kingdom	COVID-19 (Coronavirus)
Catton parkrun	United Kingdom	COVID-19 (Coronavirus)
Centennial parkrun	Australia	Eastern Suburbs covid-19 cluster.
Central Park junior parkrun	United Kingdom	COVID-19 (Coronavirus)
Central parkrun, Burnaby	Canada	COVID-19 (Coronavirus)
Central parkrun, Plymouth	United Kingdom	COVID-19 (Coronavirus)
Centre Vale parkrun	United Kingdom	COVID-19 (Coronavirus)
Century City parkrun	South Africa	COVID-19 (Coronavirus)
Ceres parkrun	South Africa	COVID-19 (Coronavirus)
Chadderton Hall parkrun	United Kingdom	COVID-19 (Coronavirus)
Chain of Lakes parkrun	Canada	COVID-19 (Coronavirus)
Chalkwell Beach parkrun	United Kingdom	COVID-19 (Coronavirus)
Chasewater parkrun	United Kingdom	COVID-19 (Coronavirus)
Cheadle Hulme parkrun	United Kingdom	COVID-19 (Coronavirus)
Chelmsford Central parkrun	United Kingdom	COVID-19 (Coronavirus)
Chelsea Bicentennial parkrun	Australia	Path closure preventing access to our course
Cheltenham parkrun	United Kingdom	COVID-19 (Coronavirus)
Cherry Orchard junior parkrun	Ireland	COVID-19 (Coronavirus)
Cheshunt junior parkrun	United Kingdom	COVID-19 (Coronavirus)
Chester parkrun	United Kingdom	COVID-19 (Coronavirus)
Chevin Forest parkrun	United Kingdom	COVID-19 (Coronavirus)
Chichester parkrun	United Kingdom	COVID-19 (Coronavirus)
Chilton Fields parkrun	United Kingdom	COVID-19 (Coronavirus)
Chippenham parkrun	United Kingdom	COVID-19 (Coronavirus)
Chipping Norton School parkrun	United Kingdom	COVID-19 (Coronavirus)
Chipping Norton parkrun	Australia	COVID19 - NSW Restrictions
Chipping Sodbury parkrun	United Kingdom	COVID-19 (Coronavirus)
Christiana parkrun	South Africa	COVID-19 (Coronavirus)
Church Mead parkrun	United Kingdom	COVID-19 (Coronavirus)
Churchill Parkway parkrun	Canada	COVID-19 (Coronavirus)
Cirencester parkrun	United Kingdom	COVID-19 (Coronavirus)
Clacton Seafront parkrun	United Kingdom	COVID-19 (Coronavirus)
Clair parkrun	United Kingdom	COVID-19 (Coronavirus)
Clapham Common parkrun	United Kingdom	COVID-19 (Coronavirus)
Clare Castle parkrun	United Kingdom	COVID-19 (Coronavirus)
Claremorris parkrun	Ireland	COVID-19 (Coronavirus)
Clarisford parkrun	Ireland	COVID-19 (Coronavirus)
Cleethorpes parkrun	United Kingdom	COVID-19 (Coronavirus)
Clevedon Salthouse Fields parkrun	United Kingdom	COVID-19 (Coronavirus)
Cliffe Castle parkrun	United Kingdom	COVID-19 (Coronavirus)
Clifton parkrun	United Kingdom	COVID-19 (Coronavirus)
Clitheroe Castle parkrun	United Kingdom	COVID-19 (Coronavirus)
Clonakilty parkrun	Ireland	COVID-19 (Coronavirus)
Clonbur Woods parkrun	Ireland	COVID-19 (Coronavirus)
Clonmel parkrun	Ireland	COVID-19 (Coronavirus)
Clover Point parkrun	Canada	COVID-19 (Coronavirus)
Clumber Park parkrun	United Kingdom	COVID-19 (Coronavirus)
Cobaw Clunes parkrun	Australia	COVID-19 Restrictions in place
Cobh junior parkrun	Ireland	COVID-19 (Coronavirus)
Coed Cefn-pwll-du parkrun	United Kingdom	COVID-19 (Coronavirus)
Colby parkrun	United Kingdom	COVID-19 (Coronavirus)
Colchester Castle parkrun	United Kingdom	COVID-19 (Coronavirus)
Colchester junior parkrun	United Kingdom	COVID-19 (Coronavirus)
Coldham's Common parkrun	United Kingdom	COVID-19 (Coronavirus)
Colney Lane parkrun	United Kingdom	COVID-19 (Coronavirus)
Colwick parkrun	United Kingdom	COVID-19 (Coronavirus)
Con Smith parkrun	Ireland	COVID-19 (Coronavirus)
Concord parkrun, Sheffield	United Kingdom	COVID-19 (Coronavirus)
Congleton parkrun	United Kingdom	COVID-19 (Coronavirus)
Conkers parkrun	United Kingdom	COVID-19 (Coronavirus)
Constantia Greenbelt parkrun	South Africa	COVID-19 (Coronavirus)
Conwy Nature Reserve junior parkrun	United Kingdom	COVID-19 (Coronavirus)
Conwy parkrun	United Kingdom	COVID-19 (Coronavirus)
Conyngham Hall parkrun	United Kingdom	COVID-19 (Coronavirus)
Coole parkrun	Ireland	COVID-19 (Coronavirus)
Cootehill parkrun	Ireland	COVID-19 (Coronavirus)
Corby parkrun	United Kingdom	COVID-19 (Coronavirus)
Corkagh parkrun	Ireland	COVID-19 (Coronavirus)
Cosmeston Lakes parkrun	United Kingdom	COVID-19 (Coronavirus)
Cotsford Fields parkrun	United Kingdom	COVID-19 (Coronavirus)
Coventry parkrun	United Kingdom	COVID-19 (Coronavirus)
Crane Park parkrun	United Kingdom	COVID-19 (Coronavirus)
Cranleigh parkrun	United Kingdom	COVID-19 (Coronavirus)
Crathes Castle parkrun	United Kingdom	COVID-19 (Coronavirus)
Creekside parkrun	United States	COVID-19 (Coronavirus)
Crewe parkrun	United Kingdom	COVID-19 (Coronavirus)
Crichton parkrun	United Kingdom	COVID-19 (Coronavirus)
Crissy Field parkrun	United States	COVID-19 (Coronavirus)
Cromhall parkrun	United Kingdom	COVID-19 (Coronavirus)
Cronulla parkrun	Australia	Current COVID situation in Greater Sydney area
Crosby parkrun	United Kingdom	COVID-19 (Coronavirus)
Cross Flatts parkrun	United Kingdom	COVID-19 (Coronavirus)
Crosserlough junior parkrun	Ireland	COVID-19 (Coronavirus)
Croxteth Hall parkrun	United Kingdom	COVID-19 (Coronavirus)
Crystal Palace parkrun	United Kingdom	COVID-19 (Coronavirus)
Cuerden Valley parkrun	United Kingdom	COVID-19 (Coronavirus)
Cusworth Hall parkrun	United Kingdom	COVID-19 (Coronavirus)
Cwmbran parkrun	United Kingdom	COVID-19 (Coronavirus)
Cyclopark parkrun	United Kingdom	COVID-19 (Coronavirus)
Dalby Forest parkrun	United Kingdom	COVID-19 (Coronavirus)
Danehy Park parkrun	United States	COVID-19 (Coronavirus)
Darlington South Park parkrun	United Kingdom	COVID-19 (Coronavirus)
Darndale parkrun	Ireland	COVID-19 (Coronavirus)
Dartford Heath parkrun	United Kingdom	COVID-19 (Coronavirus)
Dartford parkrun	United Kingdom	COVID-19 (Coronavirus)
Daventry parkrun	United Kingdom	COVID-19 (Coronavirus)
Dean Castle Country Park parkrun	United Kingdom	COVID-19 (Coronavirus)
Deerpark Forest parkrun, Virginia	Ireland	COVID-19 (Coronavirus)
Deerpark junior parkrun	Ireland	COVID-19 (Coronavirus)
Deerpark parkrun, Carlanstown	Ireland	COVID-19 (Coronavirus)
Delamere parkrun	United Kingdom	COVID-19 (Coronavirus)
Delta parkrun	South Africa	COVID-19 (Coronavirus)
Derby Park junior parkrun	United Kingdom	COVID-19 (Coronavirus)
Derry City junior parkrun	United Kingdom	COVID-19 (Coronavirus)
Des Moines Creek parkrun	United States	COVID-19 (Coronavirus)
Dewsbury parkrun	United Kingdom	COVID-19 (Coronavirus)
Didcot parkrun	United Kingdom	COVID-19 (Coronavirus)
Dietenbach parkrun	Germany	COVID-19 (Coronavirus)
Dinton Pastures parkrun	United Kingdom	COVID-19 (Coronavirus)
Dishley parkrun, Loughborough	United Kingdom	COVID-19 (Coronavirus)
Doddington Hall parkrun	United Kingdom	COVID-19 (Coronavirus)
Dolgellau parkrun	United Kingdom	COVID-19 (Coronavirus)
Dolls Point parkrun	Australia	Current COVID situation in Greater Sydney area
Donabate parkrun	Ireland	COVID-19 (Coronavirus)
Doornhoek Farm parkrun	South Africa	Covid hotspot
Doornkop Military Base parkrun	South Africa	COVID-19 (Coronavirus)
Dover junior parkrun	United Kingdom	COVID-19 (Coronavirus)
Downsview parkrun	Canada	COVID-19 (Coronavirus)
Downview parkrun	United Kingdom	COVID-19 (Coronavirus)
Dr Bill Hammond Trails parkrun	United States	COVID-19 (Coronavirus)
Dreiländergarten parkrun	Germany	COVID-19 (Coronavirus)
Drumblade parkrun	South Africa	COVID-19 (Coronavirus)
Drumchapel parkrun	United Kingdom	COVID-19 (Coronavirus)
Drumpellier Country parkrun	United Kingdom	COVID-19 (Coronavirus)
Drumpellier junior parkrun	United Kingdom	COVID-19 (Coronavirus)
Druridge Bay parkrun	United Kingdom	COVID-19 (Coronavirus)
Dudley parkrun	United Kingdom	COVID-19 (Coronavirus)
Duffins Trail parkrun	Canada	COVID-19 (Coronavirus)
Duikersdrift parkrun, Tulbagh	South Africa	COVID-19 (Coronavirus)
Dullstroom parkrun	South Africa	COVID-19 (Coronavirus)
Duloch junior parkrun	United Kingdom	COVID-19 (Coronavirus)
Dulwich parkrun	United Kingdom	COVID-19 (Coronavirus)
Dumfries junior parkrun	United Kingdom	COVID-19 (Coronavirus)
Dundalk IT junior parkrun	Ireland	COVID-19 (Coronavirus)
Dundalk parkrun	Ireland	COVID-19 (Coronavirus)
Dunfermline parkrun	United Kingdom	COVID-19 (Coronavirus)
Dungloe parkrun	Ireland	COVID-19 (Coronavirus)
Dunstable Downs parkrun	United Kingdom	COVID-19 (Coronavirus)
Durban Point parkrun	South Africa	COVID-19 (Coronavirus)
Durbanville parkrun	South Africa	COVID-19 (Coronavirus)
Durham parkrun	United Kingdom	COVID-19 (Coronavirus)
Dusi parkrun	South Africa	COVID-19 (Coronavirus)
Duthie junior parkrun	United Kingdom	COVID-19 (Coronavirus)
Dømmesmoen parkrun	Norway	COVID-19 (Coronavirus)
East Brighton parkrun	United Kingdom	COVID-19 (Coronavirus)
East Coast Park parkrun	Singapore	COVID-19 (Coronavirus)
East Grinstead parkrun	United Kingdom	COVID-19 (Coronavirus)
East Park parkrun	United Kingdom	COVID-19 (Coronavirus)
Eastbourne parkrun	United Kingdom	COVID-19 (Coronavirus)
Eastleigh parkrun	United Kingdom	COVID-19 (Coronavirus)
Eastville parkrun	United Kingdom	COVID-19 (Coronavirus)
Ebotse parkrun	South Africa	COVID-19 (Coronavirus)
Eden Project parkrun	United Kingdom	COVID-19 (Coronavirus)
Edenvale parkrun	South Africa	COVID-19 (Coronavirus)
Edgbaston Reservoir parkrun	United Kingdom	COVID-19 (Coronavirus)
Edinburgh parkrun	United Kingdom	COVID-19 (Coronavirus)
Eglinton parkrun	United Kingdom	COVID-19 (Coronavirus)
Elder Park junior parkrun	United Kingdom	COVID-19 (Coronavirus)
Elgin parkrun	United Kingdom	COVID-19 (Coronavirus)
Ellenbrook Fields parkrun	United Kingdom	COVID-19 (Coronavirus)
Ellesmere Port parkrun	United Kingdom	COVID-19 (Coronavirus)
Ellon parkrun	United Kingdom	COVID-19 (Coronavirus)
Endcliffe parkrun	United Kingdom	COVID-19 (Coronavirus)
Eramosa River Trail parkrun	Canada	COVID-19 (Coronavirus)
Erddig parkrun	United Kingdom	COVID-19 (Coronavirus)
Ernest Ullmann parkrun	South Africa	COVID-19 (Coronavirus)
Erris parkrun	Ireland	COVID-19 (Coronavirus)
Etna parkrun	Italy	COVID-19 (Coronavirus)
Evesham parkrun	United Kingdom	COVID-19 (Coronavirus)
Exeter Riverside parkrun	United Kingdom	COVID-19 (Coronavirus)
Exmouth parkrun	United Kingdom	COVID-19 (Coronavirus)
Fairview parkrun	Ireland	COVID-19 (Coronavirus)
Falcarragh parkrun	Ireland	COVID-19 (Coronavirus)
Falkirk parkrun	United Kingdom	COVID-19 (Coronavirus)
Fareham parkrun	United Kingdom	COVID-19 (Coronavirus)
Farfalle parkrun	Italy	COVID-19 (Coronavirus)
Faskally Forest parkrun	United Kingdom	COVID-19 (Coronavirus)
Father Collins parkrun	Ireland	COVID-19 (Coronavirus)
Favorita parkrun	Italy	COVID-19 (Coronavirus)
Felixstowe parkrun	United Kingdom	COVID-19 (Coronavirus)
Fell Foot parkrun, Newby Bridge	United Kingdom	COVID-19 (Coronavirus)
Feltham parkrun	United Kingdom	COVID-19 (Coronavirus)
Ferry Meadows parkrun	United Kingdom	COVID-19 (Coronavirus)
Ferryvale parkrun	South Africa	COVID-19 (Coronavirus)
Festningen parkrun	Norway	COVID-19 (Coronavirus)
Finsbury parkrun	United Kingdom	COVID-19 (Coronavirus)
Firenze parkrun	Italy	COVID-19 (Coronavirus)
Fish Hoek parkrun	South Africa	COVID-19 (Coronavirus)
Flatts Lane parkrun	United Kingdom	COVID-19 (Coronavirus)
Fleetwood Promenade parkrun	United Kingdom	COVID-19 (Coronavirus)
Fletcher Moss parkrun	United Kingdom	COVID-19 (Coronavirus)
Folkestone parkrun	United Kingdom	COVID-19 (Coronavirus)
Foots Cray Meadows parkrun	United Kingdom	COVID-19 (Coronavirus)
Ford parkrun	United Kingdom	COVID-19 (Coronavirus)
Forest Rec parkrun	United Kingdom	COVID-19 (Coronavirus)
Forest of Dean junior parkrun	United Kingdom	COVID-19 (Coronavirus)
Forest of Dean parkrun	United Kingdom	COVID-19 (Coronavirus)
Foro Italico parkrun	Italy	COVID-19 (Coronavirus)
Fort William parkrun	United Kingdom	COVID-19 (Coronavirus)
Fountains Abbey parkrun	United Kingdom	COVID-19 (Coronavirus)
Franschhoek parkrun	South Africa	COVID-19 (Coronavirus)
Frickley Country parkrun	United Kingdom	COVID-19 (Coronavirus)
Friedrichsau parkrun	Germany	COVID-19 (Coronavirus)
Frimley Lodge parkrun	United Kingdom	COVID-19 (Coronavirus)
Frédéric Back parkrun	Canada	COVID-19 (Coronavirus)
Fulbourn Hospital parkrun	United Kingdom	COVID-19 (Coronavirus)
Fulham Palace parkrun	United Kingdom	COVID-19 (Coronavirus)
Fælledparken parkrun	Denmark	COVID-19 (Coronavirus)
Gadebridge Park junior parkrun	United Kingdom	COVID-19 (Coronavirus)
Gadebridge parkrun	United Kingdom	COVID-19 (Coronavirus)
Ganavan Sands parkrun	United Kingdom	COVID-19 (Coronavirus)
Gardenhurst Estate junior parkrun	United Kingdom	Core team not available
Gateshead parkrun	United Kingdom	COVID-19 (Coronavirus)
Gedling parkrun	United Kingdom	COVID-19 (Coronavirus)
George Lane Memorial parkrun	Canada	COVID-19 (Coronavirus)
George parkrun	South Africa	COVID-19 (Coronavirus)
Georgengarten parkrun	Germany	COVID-19 (Coronavirus)
Gibside parkrun	United Kingdom	COVID-19 (Coronavirus)
Gillies Lake parkrun	Canada	COVID-19 (Coronavirus)
Gilloolys parkrun	South Africa	COVID-19 (Coronavirus)
Girvan Prom parkrun	United Kingdom	COVID-19 (Coronavirus)
Gladstone parkrun	United Kingdom	COVID-19 (Coronavirus)
Glen River parkrun	Ireland	COVID-19 (Coronavirus)
Glengarriff parkrun	Ireland	COVID-19 (Coronavirus)
Globe parkrun	Germany	COVID-19 (Coronavirus)
Glossop parkrun	United Kingdom	COVID-19 (Coronavirus)
Gloucester City parkrun	United Kingdom	COVID-19 (Coronavirus)
Gloucester North parkrun	United Kingdom	COVID-19 (Coronavirus)
Gnoll junior parkrun	United Kingdom	COVID-19 (Coronavirus)
Gnoll parkrun	United Kingdom	COVID-19 (Coronavirus)
Goffert parkrun	Netherlands	COVID-19 (Coronavirus)
Golden Harvest parkrun	South Africa	COVID-19 (Coronavirus)
Goodwill parkrun	South Africa	COVID-19 (Coronavirus)
Goole parkrun	United Kingdom	COVID-19 (Coronavirus)
Gorey parkrun	Ireland	COVID-19 (Coronavirus)
Gorleston Cliffs parkrun	United Kingdom	COVID-19 (Coronavirus)
Goudhurst junior parkrun	United Kingdom	COVID-19 (Coronavirus)
Goulburn parkrun	Australia	Track underwater due to flooding
Grabouw parkrun	South Africa	COVID-19 (Coronavirus)
Gracepoint parkrun	South Africa	COVID-19 (Coronavirus)
Grahamstown parkrun	South Africa	COVID-19 (Coronavirus)
Grangemoor parkrun	United Kingdom	COVID-19 (Coronavirus)
Graves parkrun	United Kingdom	COVID-19 (Coronavirus)
Great Cornard parkrun	United Kingdom	COVID-19 (Coronavirus)
Great Denham parkrun	United Kingdom	COVID-19 (Coronavirus)
Great Dunmow parkrun	United Kingdom	COVID-19 (Coronavirus)
Great Lines parkrun, Medway	United Kingdom	COVID-19 (Coronavirus)
Great Notley junior parkrun	United Kingdom	COVID-19 (Coronavirus)
Great Notley parkrun	United Kingdom	COVID-19 (Coronavirus)
Great Yarmouth North Beach parkrun	United Kingdom	COVID-19 (Coronavirus)
Greenfield Valley parkrun	United Kingdom	COVID-19 (Coronavirus)
Greenock parkrun	United Kingdom	COVID-19 (Coronavirus)
Greenpoint parkrun	South Africa	COVID-19 (Coronavirus)
Greenstone Hill parkrun	South Africa	COVID-19 (Coronavirus)
Greenwich parkrun	United Kingdom	COVID-19 (Coronavirus)
Grey Goose parkrun	South Africa	COVID-19 (Coronavirus)
Greytown Woodside Trail parkrun	New Zealand	Covid alert level 2 in Wellington region
Griffeen junior parkrun	Ireland	COVID-19 (Coronavirus)
Griffeen parkrun	Ireland	COVID-19 (Coronavirus)
Groe parkrun	United Kingdom	COVID-19 (Coronavirus)
Groeneweide parkrun	South Africa	COVID-19 (Coronavirus)
Grove parkrun	United Kingdom	COVID-19 (Coronavirus)
Grovelands parkrun, Enfield	United Kingdom	COVID-19 (Coronavirus)
Grüner Weg parkrun	Germany	COVID-19 (Coronavirus)
Guildford parkrun	United Kingdom	COVID-19 (Coronavirus)
Gunnersbury parkrun	United Kingdom	COVID-19 (Coronavirus)
Gunpowder parkrun	United Kingdom	COVID-19 (Coronavirus)
Hackney Marshes parkrun	United Kingdom	COVID-19 (Coronavirus)
Hackworth parkrun	United Kingdom	COVID-19 (Coronavirus)
Hadleigh parkrun, Essex	United Kingdom	COVID-19 (Coronavirus)
Hafan Pwllheli parkrun	United Kingdom	COVID-19 (Coronavirus)
Haga parkrun	Sweden	COVID-19 (Coronavirus)
Haigh Woodland parkrun	United Kingdom	COVID-19 (Coronavirus)
Haldon Forest parkrun	United Kingdom	COVID-19 (Coronavirus)
Halifax parkrun	United Kingdom	COVID-19 (Coronavirus)
Halls parkrun, Nelspruit	South Africa	COVID-19 (Coronavirus)
Hampstead Heath parkrun	United Kingdom	COVID-19 (Coronavirus)
Hanley parkrun	United Kingdom	COVID-19 (Coronavirus)
Hanworth junior parkrun	United Kingdom	COVID-19 (Coronavirus)
Hanworth parkrun	United Kingdom	COVID-19 (Coronavirus)
Harcourt Hill parkrun	United Kingdom	COVID-19 (Coronavirus)
Harkerville parkrun	South Africa	COVID-19 (Coronavirus)
Harlow parkrun	United Kingdom	COVID-19 (Coronavirus)
Harrogate parkrun	United Kingdom	COVID-19 (Coronavirus)
Harrow Lodge parkrun	United Kingdom	COVID-19 (Coronavirus)
Harrow parkrun	United Kingdom	COVID-19 (Coronavirus)
Hartbeespoort parkrun	South Africa	COVID-19 (Coronavirus)
Hartlepool parkrun	United Kingdom	COVID-19 (Coronavirus)
Hartstown parkrun	Ireland	COVID-19 (Coronavirus)
Harwich parkrun	United Kingdom	COVID-19 (Coronavirus)
Hasenheide parkrun	Germany	COVID-19 (Coronavirus)
Hastings parkrun	United Kingdom	COVID-19 (Coronavirus)
Havant parkrun	United Kingdom	COVID-19 (Coronavirus)
Haverfordwest parkrun	United Kingdom	COVID-19 (Coronavirus)
Haverhill parkrun	United Kingdom	COVID-19 (Coronavirus)
Hay Lodge parkrun	United Kingdom	COVID-19 (Coronavirus)
Hazeldean Farm parkrun	South Africa	COVID-19 (Coronavirus)
Hazelwood parkrun	United Kingdom	COVID-19 (Coronavirus)
Hazlehead parkrun, Aberdeen	United Kingdom	COVID-19 (Coronavirus)
Hazyview parkrun	South Africa	COVID-19 (Coronavirus)
Heartlands parkrun	United Kingdom	COVID-19 (Coronavirus)
Heaton parkrun	United Kingdom	COVID-19 (Coronavirus)
Heidedal parkrun	South Africa	COVID-19 (Coronavirus)
Helix junior parkrun	United Kingdom	COVID-19 (Coronavirus)
Henderson Lake parkrun	Canada	COVID-19 (Coronavirus)
Henley Wood parkrun, Oswestry	United Kingdom	COVID-19 (Coronavirus)
Henley-on-Thames parkrun	United Kingdom	COVID-19 (Coronavirus)
Henlow Bridge Lakes parkrun	United Kingdom	COVID-19 (Coronavirus)
Henstridge Airfield parkrun	United Kingdom	COVID-19 (Coronavirus)
Hereford parkrun	United Kingdom	COVID-19 (Coronavirus)
Heritage Park junior parkrun	Ireland	COVID-19 (Coronavirus)
Hermanus parkrun	South Africa	COVID-19 (Coronavirus)
Heron Banks parkrun	South Africa	COVID-19 (Coronavirus)
Herrington Country parkrun	United Kingdom	COVID-19 (Coronavirus)
Heslington parkrun	United Kingdom	COVID-19 (Coronavirus)
Higginson parkrun, Marlow	United Kingdom	COVID-19 (Coronavirus)
Highbury Fields junior parkrun	United Kingdom	COVID-19 (Coronavirus)
Highbury Fields parkrun	United Kingdom	COVID-19 (Coronavirus)
Highwoods parkrun	United Kingdom	COVID-19 (Coronavirus)
Hillsborough parkrun	United Kingdom	COVID-19 (Coronavirus)
Hillside parkrun	South Africa	COVID-19 (Coronavirus)
Hilltop parkrun	United Kingdom	COVID-19 (Coronavirus)
Hilly Fields parkrun	United Kingdom	COVID-19 (Coronavirus)
Hilton parkrun	South Africa	COVID-19 (Coronavirus)
Hluhluwe parkrun	South Africa	COVID-19 (Coronavirus)
Hoblingwell parkrun	United Kingdom	COVID-19 (Coronavirus)
Hockgraben parkrun	Germany	COVID-19 (Coronavirus)
Hockley Woods parkrun	United Kingdom	COVID-19 (Coronavirus)
Hogmoor Inclosure parkrun	United Kingdom	COVID-19 (Coronavirus)
Hogsback parkrun	South Africa	COVID-19 (Coronavirus)
Holkham parkrun	United Kingdom	COVID-19 (Coronavirus)
Hollesley Bay parkrun	United Kingdom	COVID-19 (Coronavirus)
Holywell junior parkrun	Ireland	COVID-19 (Coronavirus)
Homestead Lake parkrun	South Africa	COVID-19 (Coronavirus)
Homewood parkrun	United Kingdom	COVID-19 (Coronavirus)
Horsham parkrun	United Kingdom	COVID-19 (Coronavirus)
Horspath parkrun	United Kingdom	COVID-19 (Coronavirus)
Horton Park parkrun	United Kingdom	COVID-19 (Coronavirus)
Houghton Hall parkrun	United Kingdom	COVID-19 (Coronavirus)
Hout Bay parkrun	South Africa	COVID-19 (Coronavirus)
Hove Park junior parkrun	United Kingdom	COVID-19 (Coronavirus)
Hove Promenade parkrun	United Kingdom	COVID-19 (Coronavirus)
Hucknall junior parkrun	United Kingdom	COVID-19 (Coronavirus)
Huddersfield parkrun	United Kingdom	COVID-19 (Coronavirus)
Huddinge parkrun	Sweden	COVID-19 (Coronavirus)
Hull parkrun	United Kingdom	COVID-19 (Coronavirus)
Humber Bridge parkrun	United Kingdom	COVID-19 (Coronavirus)
Hunstanton Promenade parkrun	United Kingdom	COVID-19 (Coronavirus)
Huntingdon parkrun	United Kingdom	COVID-19 (Coronavirus)
Hyde junior parkrun	United Kingdom	COVID-19 (Coronavirus)
Hyde parkrun	United Kingdom	COVID-19 (Coronavirus)
Hyndburn parkrun	United Kingdom	COVID-19 (Coronavirus)
Ifield Mill Pond parkrun	United Kingdom	COVID-19 (Coronavirus)
Illaunmanagh parkrun	Ireland	COVID-19 (Coronavirus)
Inch Beach parkrun	Ireland	COVID-19 (Coronavirus)
Inverell parkrun	Australia	Flood water over path
Inverleith junior parkrun	United Kingdom	COVID-19 (Coronavirus)
Inverness parkrun	United Kingdom	COVID-19 (Coronavirus)
Ipswich parkrun	United Kingdom	COVID-19 (Coronavirus)
Irchester Country parkrun	United Kingdom	COVID-19 (Coronavirus)
Isabel Trail parkrun	United Kingdom	COVID-19 (Coronavirus)
Itchen Valley Country parkrun	United Kingdom	COVID-19 (Coronavirus)
Jacobsdal parkrun	South Africa	COVID-19 (Coronavirus)
Jamaica Pond parkrun	United States	COVID-19 (Coronavirus)
Jeffreys Bay parkrun	South Africa	COVID-19 (Coronavirus)
Jersey Farm parkrun	United Kingdom	COVID-19 (Coronavirus)
Jesmond Dene parkrun	United Kingdom	COVID-19 (Coronavirus)
Joe Creason parkrun	United States	COVID-19 (Coronavirus)
Jubilee parkrun	United Kingdom	COVID-19 (Coronavirus)
Kagerzoom parkrun	Netherlands	COVID-19 (Coronavirus)
Kamay parkrun	Australia	Due to COVID-19 cases within Local Government Area
Kanata parkrun, Ottawa	Canada	COVID-19 (Coronavirus)
Kapiti Coast parkrun	New Zealand	Alert level 2 restrictions in place
Karpendonkse Plas parkrun	Netherlands	COVID-19 (Coronavirus)
Kastanienallee parkrun	Germany	COVID-19 (Coronavirus)
Kayamandi parkrun	South Africa	COVID-19 (Coronavirus)
Kei Mouth parkrun	South Africa	Country Club facilities and toilets are closed
Kenton Rec junior parkrun	United Kingdom	COVID-19 (Coronavirus)
Keppel parkrun	United Kingdom	COVID-19 (Coronavirus)
Kesgrave parkrun	United Kingdom	COVID-19 (Coronavirus)
Keswick parkrun	United Kingdom	COVID-19 (Coronavirus)
Kettering parkrun	United Kingdom	COVID-19 (Coronavirus)
Kew Woods parkrun	United Kingdom	COVID-19 (Coronavirus)
Kidds Beach parkrun	South Africa	COVID-19 (Coronavirus)
Kiessee parkrun	Germany	COVID-19 (Coronavirus)
Kilkenny parkrun	Ireland	COVID-19 (Coronavirus)
Killarney House parkrun	Ireland	COVID-19 (Coronavirus)
Killerton parkrun	United Kingdom	COVID-19 (Coronavirus)
Kimberley parkrun	South Africa	COVID-19 (Coronavirus)
King George Playing Fields junior parkrun	United Kingdom	COVID-19 (Coronavirus)
King George V Playing Field parkrun	United Kingdom	COVID-19 (Coronavirus)
King George junior parkrun	United Kingdom	COVID-19 (Coronavirus)
King's Lynn junior parkrun	United Kingdom	COVID-19 (Coronavirus)
King's Lynn parkrun	United Kingdom	COVID-19 (Coronavirus)
Kingdom parkrun	United Kingdom	COVID-19 (Coronavirus)
Kingsbury Water parkrun	United Kingdom	COVID-19 (Coronavirus)
Kingston parkrun	United Kingdom	COVID-19 (Coronavirus)
Kingsway parkrun, Gloucester	United Kingdom	COVID-19 (Coronavirus)
Kirkcaldy parkrun	United Kingdom	COVID-19 (Coronavirus)
Kirkwall parkrun	United Kingdom	COVID-19 (Coronavirus)
Kiwanis parkrun	Canada	COVID-19 (Coronavirus)
Knockanacree Woods parkrun	Ireland	COVID-19 (Coronavirus)
Knocknacarra parkrun	Ireland	COVID-19 (Coronavirus)
Knowsley parkrun	United Kingdom	COVID-19 (Coronavirus)
Knysna parkrun	South Africa	COVID-19 (Coronavirus)
Komani parkrun	South Africa	COVID-19 (Coronavirus)
Koster parkrun	South Africa	COVID-19 (Coronavirus)
Kraalkop parkrun	South Africa	COVID-19 (Coronavirus)
Kralinbergh parkrun	South Africa	COVID-19 (Coronavirus)
Kralingse Bos parkrun	Netherlands	COVID-19 (Coronavirus)
Kroonstad parkrun	South Africa	COVID-19 (Coronavirus)
Kräherwald parkrun	Germany	COVID-19 (Coronavirus)
Kungsängen parkrun	Sweden	COVID-19 (Coronavirus)
Kurpark parkrun	Germany	COVID-19 (Coronavirus)
Kurt-Schumacher-Promenade parkrun	Germany	COVID-19 (Coronavirus)
KwaMashu parkrun	South Africa	COVID-19 (Coronavirus)
Kwanele parkrun	South Africa	COVID-19 (Coronavirus)
Küchenholz parkrun	Germany	COVID-19 (Coronavirus)
La Mandria parkrun	Italy	COVID-19 (Coronavirus)
Lady Slipper parkrun	South Africa	COVID-19 (Coronavirus)
Ladybrand parkrun	South Africa	COVID-19 (Coronavirus)
Ladysmith parkrun	South Africa	COVID-19 (Coronavirus)
Lahnwiesen parkrun	Germany	COVID-19 (Coronavirus)
Lakes junior parkrun	United Kingdom	COVID-19 (Coronavirus)
Lanark Moor parkrun	United Kingdom	COVID-19 (Coronavirus)
Lancaster parkrun	United Kingdom	COVID-19 (Coronavirus)
Lancefield parkrun	Australia	Unsafe track due to storm damage
Lancing Beach Green parkrun	United Kingdom	COVID-19 (Coronavirus)
Land's End parkrun	United Kingdom	COVID-19 (Coronavirus)
Landesgartenschau Park parkrun	Germany	COVID-19 (Coronavirus)
Langebaan parkrun	South Africa	COVID-19 (Coronavirus)
Langenhoven parkrun	South Africa	COVID-19 (Coronavirus)
Lanhydrock parkrun	United Kingdom	COVID-19 (Coronavirus)
Lanseria parkrun	South Africa	COVID-19 (Coronavirus)
Larne junior parkrun	United Kingdom	COVID-19 (Coronavirus)
Latchmere Rec junior parkrun	United Kingdom	COVID-19 (Coronavirus)
Laudium parkrun	South Africa	COVID-19 (Coronavirus)
Leamington parkrun	United Kingdom	COVID-19 (Coronavirus)
Leazes parkrun	United Kingdom	COVID-19 (Coronavirus)
Lebone parkrun	South Africa	COVID-19 (Coronavirus)
Lee-on-the-Solent parkrun	United Kingdom	COVID-19 (Coronavirus)
Lees Road parkrun	Ireland	COVID-19 (Coronavirus)
Leeupan parkrun	South Africa	COVID-19 (Coronavirus)
Leicester Victoria parkrun	United Kingdom	COVID-19 (Coronavirus)
Leinpfad parkrun	Germany	COVID-19 (Coronavirus)
Letchworth parkrun	United Kingdom	COVID-19 (Coronavirus)
Letterkenny parkrun	Ireland	COVID-19 (Coronavirus)
Levengrove parkrun	United Kingdom	COVID-19 (Coronavirus)
Lews Castle parkrun	United Kingdom	COVID-19 (Coronavirus)
Lichtenburg Raceway parkrun	South Africa	COVID-19 (Coronavirus)
Limerick parkrun	Ireland	COVID-19 (Coronavirus)
Lincoln parkrun	United Kingdom	COVID-19 (Coronavirus)
Linford Wood parkrun	United Kingdom	COVID-19 (Coronavirus)
Lingwood parkrun	United Kingdom	COVID-19 (Coronavirus)
Linwood parkrun	United Kingdom	COVID-19 (Coronavirus)
Listowel parkrun	Ireland	COVID-19 (Coronavirus)
Littlehampton Prom parkrun	United Kingdom	COVID-19 (Coronavirus)
Littleport parkrun	United Kingdom	COVID-19 (Coronavirus)
Livingston parkrun	United Kingdom	COVID-19 (Coronavirus)
Llanelli Coast junior parkrun	United Kingdom	COVID-19 (Coronavirus)
Llanelli Coast parkrun	United Kingdom	COVID-19 (Coronavirus)
Llanerchaeron parkrun	United Kingdom	COVID-19 (Coronavirus)
Lloyd parkrun, Croydon	United Kingdom	COVID-19 (Coronavirus)
Llyn Llech Owain parkrun	United Kingdom	COVID-19 (Coronavirus)
Loch Leven parkrun	United Kingdom	COVID-19 (Coronavirus)
Loch Neaton parkrun, Watton	United Kingdom	COVID-19 (Coronavirus)
Lochend Woods parkrun	United Kingdom	COVID-19 (Coronavirus)
Lochore Meadows parkrun	United Kingdom	COVID-19 (Coronavirus)
London Fields junior parkrun	United Kingdom	COVID-19 (Coronavirus)
Lonehill parkrun	South Africa	COVID-19 (Coronavirus)
Long Eaton parkrun	United Kingdom	COVID-19 (Coronavirus)
Longford junior parkrun	Ireland	COVID-19 (Coronavirus)
Longford parkrun	Ireland	COVID-19 (Coronavirus)
Longrun Meadow parkrun	United Kingdom	COVID-19 (Coronavirus)
Lough Key parkrun	Ireland	COVID-19 (Coronavirus)
Lough Lannagh junior parkrun	Ireland	COVID-19 (Coronavirus)
Louis Trichardt parkrun	South Africa	COVID-19 (Coronavirus)
Lower Drummans parkrun	United Kingdom	COVID-19 (Coronavirus)
Lower Hutt parkrun	New Zealand	Alert Level 2 Restrictions in place
Lowestoft parkrun	United Kingdom	COVID-19 (Coronavirus)
Ludlow parkrun	United Kingdom	COVID-19 (Coronavirus)
Luitpold parkrun	Germany	COVID-19 (Coronavirus)
Lullingstone parkrun	United Kingdom	COVID-19 (Coronavirus)
Luton Wardown parkrun	United Kingdom	COVID-19 (Coronavirus)
Lydiard parkrun	United Kingdom	COVID-19 (Coronavirus)
Lydney parkrun	United Kingdom	COVID-19 (Coronavirus)
Lyme Park parkrun	United Kingdom	COVID-19 (Coronavirus)
Lymington Woodside parkrun	United Kingdom	COVID-19 (Coronavirus)
Lytham Hall parkrun	United Kingdom	COVID-19 (Coronavirus)
Løvstien parkrun, Bergen	Norway	COVID-19 (Coronavirus)
Maaraue parkrun	Germany	COVID-19 (Coronavirus)
MacRosty junior parkrun	United Kingdom	COVID-19 (Coronavirus)
Macclesfield parkrun	United Kingdom	COVID-19 (Coronavirus)
Maesteg parkrun	United Kingdom	COVID-19 (Coronavirus)
Maidenhead parkrun	United Kingdom	COVID-19 (Coronavirus)
Maidstone parkrun	United Kingdom	COVID-19 (Coronavirus)
Malahide Castle junior parkrun	Ireland	COVID-19 (Coronavirus)
Malahide parkrun	Ireland	COVID-19 (Coronavirus)
Maldon Prom junior parkrun	United Kingdom	COVID-19 (Coronavirus)
Maldon Prom parkrun	United Kingdom	COVID-19 (Coronavirus)
Mallards Pike parkrun	United Kingdom	COVID-19 (Coronavirus)
Malling parkrun	United Kingdom	COVID-19 (Coronavirus)
Mallow Castle parkrun	Ireland	COVID-19 (Coronavirus)
Malmesbury parkrun	South Africa	COVID-19 (Coronavirus)
Malmö Ribersborg parkrun	Sweden	COVID-19 (Coronavirus)
Manor Field parkrun, Whittlesey	United Kingdom	COVID-19 (Coronavirus)
Manor Park junior parkrun	United Kingdom	COVID-19 (Coronavirus)
Mansfield OH parkrun	United States	COVID-19 (Coronavirus)
Mansfield parkrun	United Kingdom	COVID-19 (Coronavirus)
Mapetla parkrun	South Africa	COVID-19 (Coronavirus)
March parkrun	United Kingdom	COVID-19 (Coronavirus)
Marecchia parkrun	Italy	COVID-19 (Coronavirus)
Margate parkrun	United Kingdom	COVID-19 (Coronavirus)
Markeaton parkrun	United Kingdom	COVID-19 (Coronavirus)
Market Harborough parkrun	United Kingdom	COVID-19 (Coronavirus)
Market Rasen Racecourse parkrun	United Kingdom	COVID-19 (Coronavirus)
Marlay junior parkrun	Ireland	COVID-19 (Coronavirus)
Marlay parkrun	Ireland	COVID-19 (Coronavirus)
Marlborough Common parkrun	United Kingdom	COVID-19 (Coronavirus)
Marple junior parkrun	United Kingdom	Grass now too long to be runnable safely.
Marple parkrun	United Kingdom	COVID-19 (Coronavirus)
Marsh-Billings-Rockefeller parkrun	United States	COVID-19 (Coronavirus)
Marshall Drive parkrun, Brotton	United Kingdom	COVID-19 (Coronavirus)
Mashishing parkrun	South Africa	COVID-19 (Coronavirus)
Matlosana Bird parkrun	South Africa	COVID-19 (Coronavirus)
Mbabane parkrun	South Africa	COVID-19 (Coronavirus)
McAllister parkrun	United States	COVID-19 (Coronavirus)
Meadowmill parkrun	United Kingdom	COVID-19 (Coronavirus)
Meadowvale parkrun	Canada	COVID-19 (Coronavirus)
Medina I.O.W. parkrun	United Kingdom	COVID-19 (Coronavirus)
Medway junior parkrun	United Kingdom	COVID-19 (Coronavirus)
Melkbosstrand parkrun	South Africa	COVID-19 (Coronavirus)
Melksham parkrun	United Kingdom	COVID-19 (Coronavirus)
Melton Mowbray parkrun	United Kingdom	COVID-19 (Coronavirus)
Menai parkrun	Australia	Current COVID situation in Greater Sydney area
Mendel Riverbank parkrun	Canada	COVID-19 (Coronavirus)
Mensola parkrun	Italy	COVID-19 (Coronavirus)
Mersea Island parkrun	United Kingdom	COVID-19 (Coronavirus)
Merthyr parkrun	United Kingdom	COVID-19 (Coronavirus)
Meyers Farm parkrun	South Africa	COVID-19 (Coronavirus)
Meyerton parkrun	South Africa	COVID-19 (Coronavirus)
Middelburg parkrun	South Africa	COVID-19 (Coronavirus)
Middleton Woods parkrun	United Kingdom	COVID-19 (Coronavirus)
Midstream parkrun	South Africa	COVID-19 (Coronavirus)
Milano Nord parkrun	Italy	COVID-19 (Coronavirus)
Mile End junior parkrun	United Kingdom	COVID-19 (Coronavirus)
Mile End parkrun	United Kingdom	COVID-19 (Coronavirus)
Milford Waterfront parkrun	United Kingdom	COVID-19 (Coronavirus)
Millennium Country parkrun, Forest of Marston Vale	United Kingdom	COVID-19 (Coronavirus)
Millfield parkrun	United Kingdom	COVID-19 (Coronavirus)
Millhouses parkrun	United Kingdom	COVID-19 (Coronavirus)
Millom parkrun	United Kingdom	COVID-19 (Coronavirus)
Milton Keynes parkrun	United Kingdom	COVID-19 (Coronavirus)
Minehead parkrun	United Kingdom	COVID-19 (Coronavirus)
Mitchells Plain parkrun	South Africa	COVID-19 (Coronavirus)
Modderfontein Reserve parkrun	South Africa	COVID-19 (Coronavirus)
Modimolle parkrun	South Africa	COVID-19 (Coronavirus)
Mofolo parkrun	South Africa	COVID-19 (Coronavirus)
Mole Valley parkrun	United Kingdom	COVID-19 (Coronavirus)
Monaghan Town parkrun	Ireland	COVID-19 (Coronavirus)
Monrepos parkrun	Germany	COVID-19 (Coronavirus)
Montelepre parkrun	Italy	COVID-19 (Coronavirus)
Montrose parkrun	United Kingdom	COVID-19 (Coronavirus)
Moormead junior parkrun	United Kingdom	COVID-19 (Coronavirus)
Moors Valley parkrun	United Kingdom	COVID-19 (Coronavirus)
Morecambe Prom parkrun	United Kingdom	COVID-19 (Coronavirus)
Mosman parkrun	Australia	COVID risk. Event team on Stay at Home orders.
Mount Edgcumbe parkrun	United Kingdom	COVID-19 (Coronavirus)
Mount Stuart parkrun	United Kingdom	COVID-19 (Coronavirus)
Mountain Goat Trail parkrun	United States	COVID-19 (Coronavirus)
Mountlucas parkrun	Ireland	COVID-19 (Coronavirus)
Moussette parkrun	Canada	COVID-19 (Coronavirus)
Mthatha parkrun	South Africa	COVID-19 (Coronavirus)
Mullingar parkrun	Ireland	COVID-19 (Coronavirus)
Mundy parkrun	Canada	COVID-19 (Coronavirus)
Mungret parkrun	Ireland	COVID-19 (Coronavirus)
Mura di Lucca parkrun	Italy	COVID-19 (Coronavirus)
Myrtle parkrun	United Kingdom	COVID-19 (Coronavirus)
Máxima parkrun	Netherlands	COVID-19 (Coronavirus)
Naas parkrun	Ireland	COVID-19 (Coronavirus)
Nahoon Point parkrun	South Africa	COVID-19 (Coronavirus)
Nansenparken parkrun	Norway	COVID-19 (Coronavirus)
Nant y Pandy parkrun	United Kingdom	COVID-19 (Coronavirus)
Narin Beach parkrun	Ireland	COVID-19 (Coronavirus)
Nautical parkrun	Canada	COVID-19 (Coronavirus)
Navan parkrun	Ireland	COVID-19 (Coronavirus)
Neckarau parkrun	Germany	COVID-19 (Coronavirus)
Neckarufer parkrun, Esslingen	Germany	COVID-19 (Coronavirus)
Netley Abbey parkrun	United Kingdom	COVID-19 (Coronavirus)
New Earswick parkrun	United Kingdom	COVID-19 (Coronavirus)
New Ross parkrun	Ireland	COVID-19 (Coronavirus)
New York Central Fitness Trail parkrun	Canada	COVID-19 (Coronavirus)
Newark parkrun	United Kingdom	COVID-19 (Coronavirus)
Newbiggin-by-the-Sea parkrun	United Kingdom	COVID-19 (Coronavirus)
Newborough Forest parkrun	United Kingdom	COVID-19 (Coronavirus)
Newbury parkrun	United Kingdom	COVID-19 (Coronavirus)
Newcastle West parkrun	Ireland	COVID-19 (Coronavirus)
Newent parkrun, Forest of Dean	United Kingdom	COVID-19 (Coronavirus)
Newport junior parkrun	United Kingdom	COVID-19 (Coronavirus)
Newport parkrun	United Kingdom	COVID-19 (Coronavirus)
Newtown parkrun	United Kingdom	COVID-19 (Coronavirus)
Nidda parkrun	Germany	COVID-19 (Coronavirus)
Nonsuch parkrun	United Kingdom	COVID-19 (Coronavirus)
Normanby Hall parkrun	United Kingdom	COVID-19 (Coronavirus)
Norre Katts parkrun	Sweden	COVID-19 (Coronavirus)
North Bay parkrun	Canada	COVID-19 (Coronavirus)
North Beach parkrun	South Africa	COVID-19 (Coronavirus)
North Sydney parkrun	Australia	Covid situation in Sydney
Northala Fields parkrun	United Kingdom	COVID-19 (Coronavirus)
Northallerton parkrun	United Kingdom	COVID-19 (Coronavirus)
Northampton parkrun	United Kingdom	COVID-19 (Coronavirus)
Northwich junior parkrun	United Kingdom	COVID-19 (Coronavirus)
Northwich parkrun	United Kingdom	COVID-19 (Coronavirus)
Norwich parkrun	United Kingdom	COVID-19 (Coronavirus)
Nose Hill parkrun	Canada	COVID-19 (Coronavirus)
Nostell parkrun	United Kingdom	COVID-19 (Coronavirus)
Nottingham Road parkrun	South Africa	COVID-19 (Coronavirus)
Nova Prestatyn parkrun	United Kingdom	COVID-19 (Coronavirus)
Oak Hill parkrun	United Kingdom	COVID-19 (Coronavirus)
Oaklands parkrun	United Kingdom	COVID-19 (Coronavirus)
Oakwell Hall parkrun	United Kingdom	COVID-19 (Coronavirus)
Oberwald parkrun	Germany	COVID-19 (Coronavirus)
Offenthal parkrun	Germany	COVID-19 (Coronavirus)
Ohio and Erie Canal Reservation parkrun	United States	COVID-19 (Coronavirus)
Okanagan parkrun	Canada	COVID-19 (Coronavirus)
Old Deer Park parkrun	United Kingdom	COVID-19 (Coronavirus)
Oldbridge parkrun	Ireland	COVID-19 (Coronavirus)
Oldham parkrun	United Kingdom	COVID-19 (Coronavirus)
Omeya parkrun	South Africa	Covid-19 Regulations
Oranmore junior parkrun	Ireland	COVID-19 (Coronavirus)
Oranmore parkrun	Ireland	COVID-19 (Coronavirus)
Oriam parkrun	United Kingdom	COVID-19 (Coronavirus)
Orleans parkrun	Canada	COVID-19 (Coronavirus)
Ormeau junior parkrun	United Kingdom	COVID-19 (Coronavirus)
Ormeau parkrun	United Kingdom	Cannot run under current restrictions
Ormskirk parkrun	United Kingdom	COVID-19 (Coronavirus)
Orpington parkrun	United Kingdom	COVID-19 (Coronavirus)
Osterley parkrun	United Kingdom	COVID-19 (Coronavirus)
Oudtshoorn parkrun	South Africa	COVID-19 (Coronavirus)
Oughterard parkrun	Ireland	COVID-19 (Coronavirus)
Outeniquasbosch parkrun	South Africa	COVID-19 (Coronavirus)
Outlook and District Regional parkrun	Canada	COVID-19 (Coronavirus)
Oxford parkrun	United Kingdom	COVID-19 (Coronavirus)
PE Hobie Beach parkrun	South Africa	COVID-19 (Coronavirus)
Paarl parkrun	South Africa	COVID-19 (Coronavirus)
Padiham Greenway junior parkrun	United Kingdom	COVID-19 (Coronavirus)
Panshanger parkrun	United Kingdom	COVID-19 (Coronavirus)
Parc parkrun	United Kingdom	COVID-19 (Coronavirus)
Park Wood junior parkrun	United Kingdom	COVID-19 (Coronavirus)
Parke parkrun	United Kingdom	COVID-19 (Coronavirus)
Parys parkrun	South Africa	COVID-19 (Coronavirus)
Peace Valley parkrun	United States	COVID-19 (Coronavirus)
Peacehaven parkrun	United Kingdom	COVID-19 (Coronavirus)
Peckham Rye parkrun	United Kingdom	COVID-19 (Coronavirus)
Peel Park junior parkrun, Little Hulton	United Kingdom	COVID-19 (Coronavirus)
Peel parkrun	United Kingdom	COVID-19 (Coronavirus)
Pegwell Bay parkrun	United Kingdom	COVID-19 (Coronavirus)
Penallta junior parkrun	United Kingdom	COVID-19 (Coronavirus)
Penallta parkrun	United Kingdom	COVID-19 (Coronavirus)
Pendle parkrun	United Kingdom	COVID-19 (Coronavirus)
Penistone parkrun	United Kingdom	COVID-19 (Coronavirus)
Pennington Flash parkrun	United Kingdom	COVID-19 (Coronavirus)
Penrhyn parkrun	United Kingdom	COVID-19 (Coronavirus)
Penrith parkrun	United Kingdom	COVID-19 (Coronavirus)
Penrose parkrun	United Kingdom	COVID-19 (Coronavirus)
Penryn Campus parkrun	United Kingdom	COVID-19 (Coronavirus)
Penticton parkrun	Canada	COVID-19 (Coronavirus)
Perrigo parkrun	United States	COVID-19 (Coronavirus)
Perry Hall parkrun	United Kingdom	COVID-19 (Coronavirus)
Perth parkrun	United Kingdom	COVID-19 (Coronavirus)
Peter Pan parkrun	United Kingdom	COVID-19 (Coronavirus)
Phoenix Park parkrun	South Africa	COVID-19 (Coronavirus)
Phoenix parkrun	United Kingdom	COVID-19 (Coronavirus)
Pieschener Allee parkrun	Germany	COVID-19 (Coronavirus)
Piggly Wiggly parkrun	South Africa	COVID-19 (Coronavirus)
Plean parkrun	United Kingdom	COVID-19 (Coronavirus)
Plymvalley parkrun	United Kingdom	COVID-19 (Coronavirus)
Pobalscoil na Tríonóide parkrun	Ireland	COVID-19 (Coronavirus)
Pocket parkrun	United Kingdom	COVID-19 (Coronavirus)
Polkemmet Country parkrun	United Kingdom	COVID-19 (Coronavirus)
Pollok parkrun, Glasgow	United Kingdom	COVID-19 (Coronavirus)
Polokwane parkrun	South Africa	COVID-19 (Coronavirus)
Pomphrey Hill parkrun	United Kingdom	COVID-19 (Coronavirus)
Pont y Bala parkrun	United Kingdom	COVID-19 (Coronavirus)
Pontefract parkrun	United Kingdom	COVID-19 (Coronavirus)
Pontypool junior parkrun	United Kingdom	COVID-19 (Coronavirus)
Pontypool parkrun	United Kingdom	COVID-19 (Coronavirus)
Pontypridd junior parkrun	United Kingdom	COVID-19 (Coronavirus)
Pontypridd parkrun	United Kingdom	COVID-19 (Coronavirus)
Poolbeg parkrun	Ireland	COVID-19 (Coronavirus)
Poole parkrun	United Kingdom	COVID-19 (Coronavirus)
Poolsbrook parkrun	United Kingdom	COVID-19 (Coronavirus)
Poppintree parkrun	Ireland	COVID-19 (Coronavirus)
Porch Field parkrun	Ireland	COVID-19 (Coronavirus)
Porirua parkrun	New Zealand	Wellington elevated to Covid-19 Level 2
Port Alfred parkrun	South Africa	COVID-19 (Coronavirus)
Porterstown parkrun	Ireland	COVID-19 (Coronavirus)
Porthcawl parkrun	United Kingdom	COVID-19 (Coronavirus)
Portobello parkrun, Edinburgh	United Kingdom	COVID-19 (Coronavirus)
Portrack parkrun	United Kingdom	COVID-19 (Coronavirus)
Portsmouth Lakeside parkrun	United Kingdom	COVID-19 (Coronavirus)
Portumna parkrun	Ireland	COVID-19 (Coronavirus)
Potchefstroom parkrun	South Africa	COVID-19 (Coronavirus)
Potternewton parkrun	United Kingdom	COVID-19 (Coronavirus)
Presint 18 parkrun, Putrajaya	Malaysia	COVID-19 (Coronavirus)
Prestatyn Prom junior parkrun	United Kingdom	COVID-19 (Coronavirus)
Preston Park parkrun, Brighton	United Kingdom	COVID-19 (Coronavirus)
Preston parkrun	United Kingdom	COVID-19 (Coronavirus)
Prestwick Oval junior parkrun	United Kingdom	COVID-19 (Coronavirus)
Prieska parkrun	South Africa	COVID-19 (Coronavirus)
Prince Albert parkrun	South Africa	COVID-19 (Coronavirus)
Princes parkrun, Liverpool	United Kingdom	COVID-19 (Coronavirus)
Progression parkrun	Ireland	COVID-19 (Coronavirus)
Prospect parkrun	United Kingdom	COVID-19 (Coronavirus)
Prudhoe Riverside junior parkrun	United Kingdom	COVID-19 (Coronavirus)
Prudhoe Riverside parkrun	United Kingdom	COVID-19 (Coronavirus)
Puckapunyal parkrun	Australia	No volunteers
Pymmes parkrun	United Kingdom	COVID-19 (Coronavirus)
Queanbeyan parkrun	Australia	Course is flooded due to large amounts of rain
Queen Elizabeth parkrun	United Kingdom	COVID-19 (Coronavirus)
Queen's Park junior parkrun, London	United Kingdom	COVID-19 (Coronavirus)
Queen's parkrun, Glasgow	United Kingdom	COVID-19 (Coronavirus)
Randfontein parkrun	South Africa	COVID-19 (Coronavirus)
Raphael parkrun	United Kingdom	COVID-19 (Coronavirus)
Reading parkrun	United Kingdom	COVID-19 (Coronavirus)
Reculver junior parkrun	United Kingdom	COVID-19 (Coronavirus)
Red Star parkrun	South Africa	COVID-19 (Coronavirus)
Redcar junior parkrun	United Kingdom	COVID-19 (Coronavirus)
Redcar parkrun	United Kingdom	COVID-19 (Coronavirus)
Reigate Priory junior parkrun	United Kingdom	COVID-19 (Coronavirus)
Reigate Priory parkrun	United Kingdom	COVID-19 (Coronavirus)
Renton parkrun	United States	COVID-19 (Coronavirus)
Rheinaue parkrun	Germany	COVID-19 (Coronavirus)
Rheinpark parkrun	Germany	COVID-19 (Coronavirus)
Rhodes parkrun	Australia	due to the current COVID situation in Sydney
Richards Bay parkrun	South Africa	COVID-19 (Coronavirus)
Richmond Olympic parkrun	Canada	COVID-19 (Coronavirus)
Richmond parkrun	United Kingdom	COVID-19 (Coronavirus)
Rickmansworth parkrun	United Kingdom	COVID-19 (Coronavirus)
Riddlesdown parkrun	United Kingdom	COVID-19 (Coronavirus)
Riemer parkrun	Germany	COVID-19 (Coronavirus)
Rietvlei parkrun, JHB South	South Africa	COVID-19 (Coronavirus)
Ringsend junior parkrun	Ireland	COVID-19 (Coronavirus)
Rising Sun parkrun	United Kingdom	COVID-19 (Coronavirus)
River Oaks parkrun	Canada	COVID-19 (Coronavirus)
River Valley parkrun	Ireland	COVID-19 (Coronavirus)
River Valley parkrun, Edmonton	Canada	COVID-19 (Coronavirus)
Riverbank parkrun	Australia	Flood Waters covering the course.
Riverfields parkrun	South Africa	COVID-19 (Coronavirus)
Riverfront parkrun	United Kingdom	COVID-19 (Coronavirus)
Riverside Gardens junior parkrun	United Kingdom	COVID-19 (Coronavirus)
Riverside junior parkrun	United Kingdom	COVID-19 (Coronavirus)
Riverside parkrun	United Kingdom	COVID-19 (Coronavirus)
Riviera on Vaal parkrun	South Africa	COVID-19 (Coronavirus)
Roberts Park parkrun	United Kingdom	COVID-19 (Coronavirus)
Robertson parkrun	South Africa	COVID-19 (Coronavirus)
Rock Creek Trail parkrun	United States	COVID-19 (Coronavirus)
Rockfield junior parkrun	Ireland	COVID-19 (Coronavirus)
Roding Valley parkrun	United Kingdom	COVID-19 (Coronavirus)
Rogiet parkrun	United Kingdom	COVID-19 (Coronavirus)
Roma Pineto parkrun	Italy	COVID-19 (Coronavirus)
Rondebosch Common parkrun	South Africa	COVID-19 (Coronavirus)
Rondebult parkrun	South Africa	COVID-19 (Coronavirus)
Roodepoort parkrun	South Africa	COVID-19 (Coronavirus)
Root 44 parkrun	South Africa	COVID-19 (Coronavirus)
Rooty Hill parkrun	Australia	NSW COVID public order restrictions
Rose parkrun, Lenasia	South Africa	COVID-19 (Coronavirus)
Roses parkrun	South Africa	COVID-19 (Coronavirus)
Rosliston parkrun	United Kingdom	COVID-19 (Coronavirus)
Ross-on-Wye parkrun	United Kingdom	COVID-19 (Coronavirus)
Rostrevor parkrun	United Kingdom	COVID-19 (Coronavirus)
Rothay Park parkrun	United Kingdom	COVID-19 (Coronavirus)
Rother Valley parkrun	United Kingdom	COVID-19 (Coronavirus)
Rotherham parkrun	United Kingdom	COVID-19 (Coronavirus)
Rothwell parkrun	United Kingdom	COVID-19 (Coronavirus)
Rouken Glen junior parkrun	United Kingdom	COVID-19 (Coronavirus)
Roundhay parkrun	United Kingdom	COVID-19 (Coronavirus)
Roundshaw Downs parkrun	United Kingdom	COVID-19 (Coronavirus)
Rouse Hill parkrun	Australia	Volunteer coverage due to covid restrictions
Royal Canal parkrun, Kilcock	Ireland	COVID-19 (Coronavirus)
Royal Tunbridge Wells parkrun	United Kingdom	COVID-19 (Coronavirus)
Rubbenbruchsee parkrun	Germany	COVID-19 (Coronavirus)
Ruchill parkrun	United Kingdom	COVID-19 (Coronavirus)
Rugby parkrun	United Kingdom	COVID-19 (Coronavirus)
Ruimsig parkrun	South Africa	COVID-19 (Coronavirus)
Rush junior parkrun	Ireland	COVID-19 (Coronavirus)
Rushcliffe parkrun	United Kingdom	COVID-19 (Coronavirus)
Rushmere parkrun	United Kingdom	COVID-19 (Coronavirus)
Rushmoor parkrun	United Kingdom	COVID-19 (Coronavirus)
Russborough parkrun	Ireland	COVID-19 (Coronavirus)
Rutland Water parkrun	United Kingdom	COVID-19 (Coronavirus)
Röthelheimpark parkrun	Germany	COVID-19 (Coronavirus)
Saint-Paulin parkrun	Canada	COVID-19 (Coronavirus)
Salcey Forest parkrun	United Kingdom	COVID-19 (Coronavirus)
Sale Water parkrun	United Kingdom	COVID-19 (Coronavirus)
Salento parkrun	Italy	COVID-19 (Coronavirus)
Salisbury parkrun	United Kingdom	COVID-19 (Coronavirus)
Saltwell junior parkrun	United Kingdom	COVID-19 (Coronavirus)
Sandall Park junior parkrun	United Kingdom	COVID-19 (Coronavirus)
Sandall Park parkrun	United Kingdom	COVID-19 (Coronavirus)
Sandhurst Memorial parkrun	United Kingdom	COVID-19 (Coronavirus)
Sands Lane parkrun	United Kingdom	COVID-19 (Coronavirus)
Sandwell Valley parkrun	United Kingdom	COVID-19 (Coronavirus)
Sardinia Bay parkrun	South Africa	COVID-19 (Coronavirus)
Schoterbos parkrun	Netherlands	COVID-19 (Coronavirus)
Schwanenteich parkrun	Germany	COVID-19 (Coronavirus)
Scunthorpe parkrun	United Kingdom	COVID-19 (Coronavirus)
Seaford Beach parkrun	United Kingdom	COVID-19 (Coronavirus)
Seaton parkrun	United Kingdom	COVID-19 (Coronavirus)
Secunda parkrun	South Africa	COVID-19 (Coronavirus)
Sedgefield junior parkrun	United Kingdom	COVID-19 (Coronavirus)
Sedgefield parkrun	United Kingdom	COVID-19 (Coronavirus)
Seewoog parkrun	Germany	COVID-19 (Coronavirus)
Selby parkrun	United Kingdom	COVID-19 (Coronavirus)
Senekal parkrun	South Africa	COVID-19 (Coronavirus)
Seven Fields parkrun	United Kingdom	COVID-19 (Coronavirus)
Severn Bridge parkrun	United Kingdom	COVID-19 (Coronavirus)
Severn Valley Country parkrun	United Kingdom	COVID-19 (Coronavirus)
Sewerby parkrun	United Kingdom	COVID-19 (Coronavirus)
Seymour Park junior parkrun	United Kingdom	COVID-19 (Coronavirus)
Shanganagh parkrun	Ireland	COVID-19 (Coronavirus)
Sharpham Road Playing Fields parkrun	United Kingdom	COVID-19 (Coronavirus)
Shawnigan Hills parkrun	Canada	COVID-19 (Coronavirus)
Sheffield Castle parkrun	United Kingdom	COVID-19 (Coronavirus)
Shelbourne junior parkrun	Ireland	COVID-19 (Coronavirus)
Shepton Mallet parkrun	United Kingdom	COVID-19 (Coronavirus)
Sheringham parkrun	United Kingdom	COVID-19 (Coronavirus)
Sherwood Pines parkrun	United Kingdom	COVID-19 (Coronavirus)
Shimanami Earthland parkrun	Japan	ボランティア人数不足
Shipley Country parkrun	United Kingdom	COVID-19 (Coronavirus)
Shirahama koen parkrun	Japan	公園の駐車場閉鎖（新型コロナウイルス感染症拡大防止）
Shongweni parkrun	South Africa	COVID-19 (Coronavirus)
Shorne Woods parkrun	United Kingdom	COVID-19 (Coronavirus)
Shrewsbury junior parkrun	United Kingdom	COVID-19 (Coronavirus)
Shrewsbury parkrun	United Kingdom	COVID-19 (Coronavirus)
Silksworth parkrun	United Kingdom	COVID-19 (Coronavirus)
Silveroaks parkrun	South Africa	COVID-19 (Coronavirus)
Sittingbourne parkrun	United Kingdom	COVID-19 (Coronavirus)
Sixfields Upton parkrun	United Kingdom	COVID-19 (Coronavirus)
Sizewell parkrun	United Kingdom	COVID-19 (Coronavirus)
Skatås parkrun	Sweden	COVID-19 (Coronavirus)
Skegness Boating Lake parkrun	United Kingdom	COVID-19 (Coronavirus)
Skipton parkrun	United Kingdom	COVID-19 (Coronavirus)
Sligo parkrun	Ireland	COVID-19 (Coronavirus)
Sloughbottom parkrun	United Kingdom	COVID-19 (Coronavirus)
Snowden Field parkrun	United Kingdom	COVID-19 (Coronavirus)
Snye Point parkrun	Canada	COVID-19 (Coronavirus)
Soham Village College parkrun	United Kingdom	COVID-19 (Coronavirus)
Somerdale Pavilion parkrun	United Kingdom	COVID-19 (Coronavirus)
Somerset West parkrun	South Africa	COVID-19 (Coronavirus)
Sonsbeek parkrun	Netherlands	COVID-19 (Coronavirus)
South Manchester parkrun	United Kingdom	COVID-19 (Coronavirus)
South Norwood parkrun	United Kingdom	COVID-19 (Coronavirus)
South Oxhey parkrun	United Kingdom	COVID-19 (Coronavirus)
South Shields parkrun	United Kingdom	COVID-19 (Coronavirus)
South Woodham Ferrers parkrun	United Kingdom	COVID-19 (Coronavirus)
Southampton parkrun	United Kingdom	COVID-19 (Coronavirus)
Southend parkrun	United Kingdom	COVID-19 (Coronavirus)
Southport parkrun	United Kingdom	COVID-19 (Coronavirus)
Southsea parkrun	United Kingdom	COVID-19 (Coronavirus)
Southwark parkrun	United Kingdom	COVID-19 (Coronavirus)
Southwick Country parkrun	United Kingdom	COVID-19 (Coronavirus)
Speyer Leinpfad parkrun	Germany	COVID-19 (Coronavirus)
Sportpark Rems parkrun	Germany	COVID-19 (Coronavirus)
Springbok parkrun	South Africa	COVID-19 (Coronavirus)
Springburn parkrun, Glasgow	United Kingdom	COVID-19 (Coronavirus)
Springhill parkrun	United Kingdom	COVID-19 (Coronavirus)
Springs parkrun	South Africa	COVID-19 (Coronavirus)
Squerryes Winery parkrun	United Kingdom	COVID-19 (Coronavirus)
St Albans parkrun	United Kingdom	COVID-19 (Coronavirus)
St Andrews parkrun	United Kingdom	COVID-19 (Coronavirus)
St Anne's junior parkrun	Ireland	COVID-19 (Coronavirus)
St Anne's parkrun	Ireland	COVID-19 (Coronavirus)
St Francis parkrun	South Africa	COVID-19 (Coronavirus)
St Helens parkrun	United Kingdom	COVID-19 (Coronavirus)
St Mary's Campus junior parkrun	Ireland	COVID-19 (Coronavirus)
St Mary's parkrun	United Kingdom	COVID-19 (Coronavirus)
St Nicholas junior parkrun	United Kingdom	COVID-19 (Coronavirus)
St Peters parkrun	Australia	Covid outbreak in Sydney
Stadspark parkrun	Netherlands	COVID-19 (Coronavirus)
Stamford Park parkrun	United Kingdom	COVID-19 (Coronavirus)
Standerton parkrun	South Africa	COVID-19 (Coronavirus)
Stavanger parkrun	Norway	COVID-19 (Coronavirus)
Sterkfontein parkrun	South Africa	COVID-19 (Coronavirus)
Stevenage junior parkrun	United Kingdom	COVID-19 (Coronavirus)
Stevenage parkrun	United Kingdom	COVID-19 (Coronavirus)
Stewart parkrun, Middlesbrough	United Kingdom	COVID-19 (Coronavirus)
Steynsrus Showground parkrun	South Africa	COVID-19 (Coronavirus)
Stirling junior parkrun	United Kingdom	COVID-19 (Coronavirus)
Stonehaven parkrun	United Kingdom	COVID-19 (Coronavirus)
Stonehouse parkrun	United Kingdom	COVID-19 (Coronavirus)
Storthes Hall parkrun	United Kingdom	COVID-19 (Coronavirus)
Strand Beach parkrun	South Africa	COVID-19 (Coronavirus)
Stranmillis College parkrun	United Kingdom	COVID-19 (Coronavirus)
Stratford Park parkrun, Stroud	United Kingdom	COVID-19 (Coronavirus)
Stratford-upon-Avon parkrun	United Kingdom	COVID-19 (Coronavirus)
Strathclyde parkrun	United Kingdom	COVID-19 (Coronavirus)
Strathcona Island parkrun	Canada	COVID-19 (Coronavirus)
Strathmartine junior parkrun	United Kingdom	COVID-19 (Coronavirus)
Street parkrun	United Kingdom	COVID-19 (Coronavirus)
Stretford parkrun	United Kingdom	COVID-19 (Coronavirus)
Strokestown parkrun	Ireland	COVID-19 (Coronavirus)
Sudbury parkrun	United Kingdom	COVID-19 (Coronavirus)
Sunnidale parkrun	Canada	COVID-19 (Coronavirus)
Sunny Hill parkrun	United Kingdom	COVID-19 (Coronavirus)
Sunrise-on-Sea parkrun	South Africa	COVID-19 (Coronavirus)
Sutherland parkrun	South Africa	COVID-19 (Coronavirus)
Sutton Manor parkrun	United Kingdom	COVID-19 (Coronavirus)
Sutton Park parkrun	United Kingdom	COVID-19 (Coronavirus)
Swadlincote junior parkrun	United Kingdom	COVID-19 (Coronavirus)
Swaffham parkrun	United Kingdom	COVID-19 (Coronavirus)
Swakopmund parkrun	South Africa	Extension of COVID restrictions
Swansea Bay parkrun	United Kingdom	COVID-19 (Coronavirus)
Swansea Prom junior parkrun	United Kingdom	COVID-19 (Coronavirus)
Swellendam parkrun	South Africa	COVID-19 (Coronavirus)
Swinfen parkrun	United Kingdom	COVID-19 (Coronavirus)
Taman Pudu Ulu parkrun	Malaysia	COVID-19 (Coronavirus)
Taman Tasik Danau Kota parkrun	Malaysia	COVID-19 (Coronavirus)
Tamar Lakes parkrun	United Kingdom	COVID-19 (Coronavirus)
Tamar Trails parkrun	United Kingdom	COVID-19 (Coronavirus)
Tampere parkrun	Finland	COVID-19 (Coronavirus)
Tapijn parkrun	Netherlands	COVID-19 (Coronavirus)
Tawd Valley parkrun	United Kingdom	COVID-19 (Coronavirus)
Tees Barrage parkrun	United Kingdom	COVID-19 (Coronavirus)
Teignmouth Promenade parkrun	United Kingdom	COVID-19 (Coronavirus)
Telford parkrun	United Kingdom	COVID-19 (Coronavirus)
Temple Newsam parkrun	United Kingdom	COVID-19 (Coronavirus)
Templemore parkrun	Ireland	COVID-19 (Coronavirus)
Terme parkrun	Italy	COVID-19 (Coronavirus)
Tern Hill parkrun	United Kingdom	COVID-19 (Coronavirus)
Terry Hershey parkrun	United States	COVID-19 (Coronavirus)
Tetbury Goods Shed parkrun	United Kingdom	COVID-19 (Coronavirus)
Tewkesbury parkrun	United Kingdom	COVID-19 (Coronavirus)
The Glen parkrun	Ireland	COVID-19 (Coronavirus)
The Grand Canal Way parkrun, Tullamore	Ireland	COVID-19 (Coronavirus)
The Grange parkrun	United Kingdom	COVID-19 (Coronavirus)
The Leas parkrun, Minster	United Kingdom	COVID-19 (Coronavirus)
The Meadows junior parkrun	United Kingdom	COVID-19 (Coronavirus)
The Old Showfield parkrun	United Kingdom	COVID-19 (Coronavirus)
The Pastures parkrun	United Kingdom	COVID-19 (Coronavirus)
The Ponds parkrun	Australia	COVID-19 restrictions in Greater Sydney
The Wammy parkrun	United Kingdom	COVID-19 (Coronavirus)
The Woodlands Waterway parkrun	United States	COVID-19 (Coronavirus)
Thetford parkrun	United Kingdom	COVID-19 (Coronavirus)
Thomas Mills parkrun	United Kingdom	COVID-19 (Coronavirus)
Thornbury parkrun	United Kingdom	COVID-19 (Coronavirus)
Thousand Hills parkrun	South Africa	COVID-19 (Coronavirus)
Thurrock parkrun, Orsett Heath	United Kingdom	COVID-19 (Coronavirus)
Thurso parkrun	United Kingdom	COVID-19 (Coronavirus)
Tilgate parkrun	United Kingdom	COVID-19 (Coronavirus)
Tinley Manor parkrun	South Africa	COVID-19 (Coronavirus)
Tokoinranta parkrun	Finland	COVID-19 (Coronavirus)
Tolka Valley parkrun	Ireland	COVID-19 (Coronavirus)
Tollcross parkrun, Glasgow	United Kingdom	COVID-19 (Coronavirus)
Tonbridge parkrun	United Kingdom	COVID-19 (Coronavirus)
Tooting Common junior parkrun	United Kingdom	COVID-19 (Coronavirus)
Tooting Common parkrun	United Kingdom	COVID-19 (Coronavirus)
Torbay Velopark parkrun	United Kingdom	COVID-19 (Coronavirus)
Torquay parkrun	Australia	Surf Coast Marathon using course
Town Moor junior parkrun	United Kingdom	COVID-19 (Coronavirus)
Town Moor parkrun	United Kingdom	COVID-19 (Coronavirus)
Tralee junior parkrun	Ireland	COVID-19 (Coronavirus)
Tralee parkrun	Ireland	COVID-19 (Coronavirus)
Tramore parkrun, Waterford	Ireland	COVID-19 (Coronavirus)
Trelai Park parkrun	United Kingdom	COVID-19 (Coronavirus)
Trelissick parkrun	United Kingdom	COVID-19 (Coronavirus)
Tremorfa parkrun	United Kingdom	COVID-19 (Coronavirus)
Trentham Memorial parkrun	New Zealand	Alert Level 2 Restrictions in place
Treviso parkrun	Italy	COVID-19 (Coronavirus)
Tring parkrun	United Kingdom	COVID-19 (Coronavirus)
Troon parkrun	United Kingdom	COVID-19 (Coronavirus)
Trout Pond parkrun	Canada	COVID-19 (Coronavirus)
Tsakane Wetlands parkrun	South Africa	COVID-19 (Coronavirus)
Tullow parkrun	Ireland	COVID-19 (Coronavirus)
Tymon parkrun	Ireland	COVID-19 (Coronavirus)
Tyne Green parkrun	United Kingdom	COVID-19 (Coronavirus)
Tyrrelstown parkrun	Ireland	COVID-19 (Coronavirus)
Tøyen parkrun	Norway	COVID-19 (Coronavirus)
Uckfield parkrun	United Kingdom	COVID-19 (Coronavirus)
Uditore parkrun	Italy	COVID-19 (Coronavirus)
Umdoni parkrun	South Africa	COVID-19 (Coronavirus)
Umhlanga parkrun	South Africa	COVID-19 (Coronavirus)
Unisee parkrun	Germany	COVID-19 (Coronavirus)
University of Stirling parkrun	United Kingdom	COVID-19 (Coronavirus)
Uppsala parkrun	Sweden	COVID-19 (Coronavirus)
Upton Court parkrun	United Kingdom	COVID-19 (Coronavirus)
Upton House parkrun	United Kingdom	COVID-19 (Coronavirus)
Ury Riverside parkrun	United Kingdom	COVID-19 (Coronavirus)
Uvongo parkrun	South Africa	COVID-19 (Coronavirus)
Vaal Marina parkrun	South Africa	COVID-19 (Coronavirus)
Valentines parkrun	United Kingdom	COVID-19 (Coronavirus)
Valhalla parkrun	South Africa	COVID-19 (Coronavirus)
Vallaskogen parkrun	Sweden	COVID-19 (Coronavirus)
Vandeleur parkrun	Ireland	COVID-19 (Coronavirus)
Vicarstown junior parkrun	Ireland	COVID-19 (Coronavirus)
Vicarstown parkrun	Ireland	COVID-19 (Coronavirus)
Victor Harbor parkrun	Australia	Key path unusable
Victoria Dock parkrun	United Kingdom	COVID-19 (Coronavirus)
Victoria Lake parkrun	South Africa	COVID-19 (Coronavirus)
Victoria junior parkrun, Glasgow	United Kingdom	COVID-19 (Coronavirus)
Victoria parkrun, Glasgow	United Kingdom	COVID-19 (Coronavirus)
Victoria parkrun, Kitchener	Canada	COVID-19 (Coronavirus)
Victoria parkrun, Truro	Canada	COVID-19 (Coronavirus)
Villiersdorp parkrun	South Africa	COVID-19 (Coronavirus)
Vogrie parkrun	United Kingdom	COVID-19 (Coronavirus)
Volksgarten parkrun	Germany	COVID-19 (Coronavirus)
Voortrekker Monument parkrun, Pretoria	South Africa	COVID-19 (Coronavirus)
Vrede parkrun	South Africa	COVID-19 (Coronavirus)
Vryburg parkrun	South Africa	COVID-19 (Coronavirus)
Växjösjön parkrun	Sweden	COVID-19 (Coronavirus)
Vääksyn kanava parkrun	Finland	COVID-19 (Coronavirus)
Wakefield Thornes parkrun	United Kingdom	COVID-19 (Coronavirus)
Wallaceneuk parkrun	United Kingdom	COVID-19 (Coronavirus)
Walmer and Deal Seafront parkrun	United Kingdom	COVID-19 (Coronavirus)
Walsall Arboretum parkrun	United Kingdom	COVID-19 (Coronavirus)
Walthamstow parkrun	United Kingdom	COVID-19 (Coronavirus)
Walton parkrun	United Kingdom	COVID-19 (Coronavirus)
Walvis Bay parkrun	South Africa	Covid 19 Regulations
Wanstead Flats parkrun	United Kingdom	COVID-19 (Coronavirus)
War Memorial Park junior parkrun	United Kingdom	COVID-19 (Coronavirus)
Wardown junior parkrun	United Kingdom	COVID-19 (Coronavirus)
Warren Hill parkrun	United Kingdom	COVID-19 (Coronavirus)
Warrington parkrun	United Kingdom	COVID-19 (Coronavirus)
Warwick Racecourse parkrun	United Kingdom	COVID-19 (Coronavirus)
Wascana parkrun	Canada	COVID-19 (Coronavirus)
Waterfall parkrun	South Africa	COVID-19 (Coronavirus)
Waterford Nature parkrun	Ireland	COVID-19 (Coronavirus)
Watergrove parkrun, Rochdale	United Kingdom	COVID-19 (Coronavirus)
Watermeadows parkrun	United Kingdom	COVID-19 (Coronavirus)
Waterstown parkrun	Ireland	COVID-19 (Coronavirus)
Wayland parkrun	United Kingdom	COVID-19 (Coronavirus)
Weavers Country Estate parkrun	South Africa	COVID-19 (Coronavirus)
Weedon Island Preserve parkrun	United States	COVID-19 (Coronavirus)
Welkom parkrun	South Africa	COVID-19 (Coronavirus)
Wellington parkrun	South Africa	COVID-19 (Coronavirus)
Wells Estate parkrun	South Africa	COVID-19 (Coronavirus)
Wendover Woods parkrun	United Kingdom	COVID-19 (Coronavirus)
Wepre parkrun	United Kingdom	COVID-19 (Coronavirus)
Werrington parkrun	United Kingdom	COVID-19 (Coronavirus)
West Coast Park parkrun	Singapore	COVID-19 (Coronavirus)
West End junior parkrun	United Kingdom	COVID-19 (Coronavirus)
West Smethwick junior parkrun	United Kingdom	COVID-19 (Coronavirus)
Westbury parkrun	South Africa	COVID-19 (Coronavirus)
Westmill parkrun	United Kingdom	COVID-19 (Coronavirus)
Westonaria parkrun	South Africa	COVID-19 (Coronavirus)
Westpark parkrun	Germany	COVID-19 (Coronavirus)
Westport parkrun	Ireland	COVID-19 (Coronavirus)
Westville parkrun	South Africa	COVID-19 (Coronavirus)
Wetherby parkrun	United Kingdom	COVID-19 (Coronavirus)
Wexford Racecourse parkrun	Ireland	COVID-19 (Coronavirus)
Weymouth parkrun	United Kingdom	COVID-19 (Coronavirus)
Whinlatter Forest parkrun	United Kingdom	COVID-19 (Coronavirus)
Whistler parkrun	Canada	COVID-19 (Coronavirus)
Whitby parkrun	Canada	COVID-19 (Coronavirus)
White River parkrun	South Africa	COVID-19 (Coronavirus)
Whitehaven parkrun	United Kingdom	COVID-19 (Coronavirus)
Whiteley junior parkrun	United Kingdom	COVID-19 (Coronavirus)
Whiteley parkrun	United Kingdom	COVID-19 (Coronavirus)
Whitley Bay junior parkrun	United Kingdom	COVID-19 (Coronavirus)
Whitley Bay parkrun	United Kingdom	COVID-19 (Coronavirus)
Whitstable parkrun	United Kingdom	COVID-19 (Coronavirus)
Wickford Memorial parkrun	United Kingdom	COVID-19 (Coronavirus)
Widnes parkrun	United Kingdom	COVID-19 (Coronavirus)
Willoughby parkrun	Australia	Oval and surrounds closed by Willoughby Council
Wilmslow parkrun	United Kingdom	COVID-19 (Coronavirus)
Wimbledon Common parkrun	United Kingdom	COVID-19 (Coronavirus)
Wimpole Estate junior parkrun	United Kingdom	COVID-19 (Coronavirus)
Wimpole Estate parkrun	United Kingdom	COVID-19 (Coronavirus)
Winchester parkrun	United Kingdom	COVID-19 (Coronavirus)
Windhoek parkrun	South Africa	Covid 19 Regulations
Windy Nook parkrun	United Kingdom	COVID-19 (Coronavirus)
Winterton parkrun	South Africa	COVID-19 (Coronavirus)
Wirral Country Park junior parkrun	United Kingdom	COVID-19 (Coronavirus)
Witbank parkrun	South Africa	COVID-19 (Coronavirus)
Witney parkrun	United Kingdom	COVID-19 (Coronavirus)
Wits parkrun	South Africa	COVID-19 (Coronavirus)
Wittelsbacher Park parkrun	Germany	COVID-19 (Coronavirus)
Witton parkrun	United Kingdom	COVID-19 (Coronavirus)
Woking parkrun	United Kingdom	COVID-19 (Coronavirus)
Wollaton Hall parkrun	United Kingdom	COVID-19 (Coronavirus)
Wolverhampton parkrun	United Kingdom	COVID-19 (Coronavirus)
Woodbank parkrun	United Kingdom	COVID-19 (Coronavirus)
Woodgate Valley Country Park parkrun	United Kingdom	COVID-19 (Coronavirus)
Woodhouse Moor parkrun	United Kingdom	COVID-19 (Coronavirus)
Woodlands parkrun	South Africa	COVID-19 (Coronavirus)
Woodley parkrun	United Kingdom	COVID-19 (Coronavirus)
Woolacombe Dunes parkrun	United Kingdom	COVID-19 (Coronavirus)
Worcester Pitchcroft parkrun	United Kingdom	COVID-19 (Coronavirus)
Worcester parkrun	United Kingdom	COVID-19 (Coronavirus)
Workington parkrun	United Kingdom	COVID-19 (Coronavirus)
Wormwood Scrubs parkrun	United Kingdom	COVID-19 (Coronavirus)
Worsley Woods parkrun	United Kingdom	COVID-19 (Coronavirus)
Worthing parkrun	United Kingdom	COVID-19 (Coronavirus)
Wotton Community PARC junior parkrun	United Kingdom	Parc being used as base for Cotswold Way Challenge
Wotton parkrun	United Kingdom	COVID-19 (Coronavirus)
Wycombe Rye junior parkrun	United Kingdom	Bucks County fair in park, alt. route not feasible
Wycombe Rye parkrun	United Kingdom	COVID-19 (Coronavirus)
Wyre Forest junior parkrun	United Kingdom	COVID-19 (Coronavirus)
Wyre Forest parkrun	United Kingdom	COVID-19 (Coronavirus)
Wythenshawe parkrun	United Kingdom	COVID-19 (Coronavirus)
Wöhrder See parkrun	Germany	COVID-19 (Coronavirus)
Yeovil Montacute parkrun	United Kingdom	COVID-19 (Coronavirus)
York parkrun	United Kingdom	COVID-19 (Coronavirus)
Yzerfontein parkrun	South Africa	COVID-19 (Coronavirus)
Zandvlei parkrun	South Africa	COVID-19 (Coronavirus)
Ziegelwiese parkrun	Germany	COVID-19 (Coronavirus)
Zuiderpark parkrun	Netherlands	COVID-19 (Coronavirus)
iMonti parkrun	South Africa	COVID-19 (Coronavirus)
parkrun Angarskie Prudy	Russia	В связи с ростом заболеваемости COVID-19 в Москве
parkrun Babushkinsky na Yauze	Russia	В связи с ростом заболеваемости COVID-19 в Москве
parkrun Bitsa	Russia	В связи с ростом заболеваемости COVID-19 в Москве
parkrun Bulwar nad Wisłą	Poland	COVID-19 (Coronavirus)
parkrun Butovo	Russia	В связи с ростом заболеваемости COVID-19 в Москве
parkrun Chertanovo Pokrovsky Park	Russia	В связи с ростом заболеваемости COVID-19 в Москве
parkrun Druzhba	Russia	В связи с ростом заболеваемости COVID-19 в Москве
parkrun Ełk	Poland	impreza Runmageddon
parkrun Filatov Lug	Russia	В связи с ростом заболеваемости COVID-19 в Москве
parkrun Fili	Russia	В связи с ростом заболеваемости COVID-19 в Москве
parkrun Gorky Park	Russia	В связи с ростом заболеваемости COVID-19 в Москве
parkrun Izmailovo	Russia	В связи с ростом заболеваемости COVID-19 в Москве
parkrun Khimki	Russia	В связи с эпидемиологической обстановкой.
parkrun Kimry	Russia	Строительная техника и ремонтные работы на трассе.
parkrun Kolomenskoe	Russia	В связи с ростом заболеваемости COVID-19 в Москве
parkrun Korolev	Russia	рост заболеваемости Covid-19 в Королёве
parkrun Krylatskoe	Russia	В связи с ростом заболеваемости COVID-19 в Москве
parkrun Kuzminki	Russia	В связи с ростом заболеваемости COVID-19 в Москве
parkrun Las Dębiński	Poland	COVID-19 (Coronavirus)
parkrun Mikhalkovo	Russia	В связи с ростом заболеваемости COVID-19 в Москве
parkrun Mitino	Russia	В связи с ростом заболеваемости COVID-19 в Москве
parkrun Ogród Saski, Lublin	Poland	inne wydarzenie w ogrodzie
parkrun Olimpiyskaya Derevnya	Russia	В связи с ростом заболеваемости COVID-19 в Москве
parkrun Park Guskova	Russia	COVID-19 (Coronavirus)
parkrun Park Radolińskich	Poland	COVID-19 (Coronavirus)
parkrun Park Talalikhina	Russia	всвязи с ростом заболеваемости COVID-19 в регионе
parkrun Perm Balatovo	Russia	COVID-19 (Coronavirus)
parkrun Pokrovskoe-Streshnevo	Russia	В связи с ростом заболеваемости COVID-19 в Москве
parkrun Readovsky Park	Russia	дополнения к указу губернатора от 16/06
parkrun Ryazan Central	Russia	COVID-19 (Coronavirus)
parkrun Ryazan Oreshek	Russia	COVID-19 (Coronavirus)
parkrun Rzeszów	Poland	COVID-19 (Coronavirus)
parkrun Severnoe Tushino	Russia	В связи с ростом заболеваемости COVID-19 в Москве
parkrun Sokolniki	Russia	В связи с ростом заболеваемости COVID-19 в Москве
parkrun Szczecinek	Poland	Przygotowujemy się wciąż do powrotu.
parkrun Timiryazevsky	Russia	В связи с ростом заболеваемости COVID-19 в Москве
parkrun Tsaritsyno	Russia	В связи с ростом заболеваемости COVID-19 в Москве
parkrun Vernadskogo	Russia	В связи с ростом заболеваемости COVID-19 в Москве
parkrun Wolbrom	Poland	Brak zespołu koordynującego
parkrun Zelenograd	Russia	В связи с ростом заболеваемости COVID-19 в Москве
parkrun de Fontainebleau	France	COVID-19 (Coronavirus)
parkrun de Montsouris	France	COVID-19 (Coronavirus)
parkrun de Rouen	France	COVID-19 (Coronavirus)
parkrun de la Ramée	France	COVID-19 (Coronavirus)
parkrun des Dougnes, Cubnezais	France	COVID-19 (Coronavirus)
parkrun du Bois de Boulogne, Paris	France	COVID-19 (Coronavirus)
parkrun du Château de Pierre de Bresse	France	COVID-19 (Coronavirus)
parkrun du Lac de Divonne	France	COVID-19 (Coronavirus)
parkrun park 850-letiya Moskvy	Russia	В связи с ростом заболеваемости COVID-19 в Москве
Örebro parkrun	Sweden	COVID-19 (Coronavirus)
